胡豆	蚕豆
歪	凶恶
左	调换
撵	追赶
跩	摔倒
号	批阅
改卷子	批阅试卷
湓	溢出
巴	粘贴
报小鸡	孵化小鸡
太费了	太调皮了
很费	很调皮
怄	生气
𤆵和	软
盐巴	盐
檐老鼠	蝙蝠
马马灯儿	蜻蜓
偷油婆	蟑螂
捱	拖延
好磨	好磨蹭
经事	韧
盅盅儿	盅
扯把子	撒谎
袜底板	鞋垫
冒皮皮	吹牛
巴适	舒服
瓢羹儿	勺子
嘎嘎	肉
棒老二	土匪
怀儿婆	孕妇
雪弹子	冰雹
古倒	吓住
四脚蛇	壁虎
磕膝菠萝	膝盖
贼娃子	小偷
破开	剖开
晏	晚
角孽	吵架
造孽	可怜
经悠	照顾
踏谑	作践
往回	以前
晓得	知道
踏踏	地方
嬢嬢	阿姨
跶一跤	摔一跤
豁	骗
掌一下	扶一下
掌倒	扶着
筶一下	试试
噗鼾	呼噜
打噗鼾	打呼噜
打噗鼾	打鼾
灶屋	厨房
背时	倒霉
二回	以后
弯酸	为难
耍	玩
跍	蹲
拢	到
活路	工作
杀果	结束
撑抖	整齐
颈项	脖子
安逸	舒服
各人	自己
婆娘	妻子
横顺	横竖
安生	打算
謱謰	邋遢
得行	能干
相因	便宜
拉丝	拉链
院坝	院子
灰面	面粉
少午	午饭
火炮儿	鞭炮
向火	烤火
皱皱	褶皱
侧边	旁边
鸡婆	母鸡
转来	回来
火闪	闪电
皮面	表面
别个	别人
人客	客人
蹄花儿	蹄髈
打伙	合伙
缺缺	缺口
不了	不止
开裂	裂开
娃儿	孩子
娃儿	小子
日你仙人板板	草拟八辈祖宗
安逸得板	舒服得很
巴倒	粘住
板眼儿多	花样多
棒球八硬	很硬
帮重	很重
苞谷	玉米
鼻达龙	鼻涕虫
不摆咯	不得了了
不得	不会
不要扭	不要动
擦擦儿	橡皮
产你两耳丝	扇你两耳光
车车儿	卷笔刀
扯把子	撒谎
扯谎	撒谎
扯经	吵架
扯经	口舌之争
扯蒲鼾	打呼噜
称展	清秀端正
吃莽莽	吃饭
吃跑堂	吃霸王餐
烂批娃儿	臭小子
令儿	蝉
令儿	知了
锤子兮兮	不厚道
锤子兮兮	缺德
打不湿	弄不湿
等于零	白搭
滴点儿	一点点
抵拢坎坎	到头
抵拢坎坎	到底
抵拢坎坎	到时候
定子	拳头
坨子	拳头
哈皮搓搓	傻傻的样子
短倒	截住
短倒	拦住
对头	正确
对头	对
对	对
二回	下次
二天	以后
发气	发脾气
烦球得很	很烦
嘎儿马洒	乱七八糟
改围剿	火并
高头	上面
搞惯球咯	养成了习惯
搞惯咯德性	养成了坏习惯
德性	习惯
德性	脾气
搞刨咯	手忙脚乱
告花子	乞丐
跟倒	立刻
跟倒	马上
怪得劈暴	丑得要命
怪眉日眼	装模作样
怪眉日眼	长相清奇
怪迷色样	奇形怪状
怪劈石山儿	奇怪
怪劈石山儿	丑陋
咣眉咣眼	委屈说不出口
龟儿子	乌龟的儿子
鬼扯	胡说八道
摆悬龙门阵	胡说八道
鬼冬瓜儿	小滑头
鬼冬瓜儿	小聪明
鬼画淘胡	鬼画桃符
鬼火胀	无名火起
鬼火冒	无名火起
鬼火冲	无名火起
鬼五六七叻	乱七八糟的
海椒	辣椒
辣椒	辣椒
憨包	傻逼
憨包	智障
哈八儿	傻逼
好汏哦	好大啊
好黑人哦	好吓人啊
汤好练哦	汤好浓稠哦
喝嘛咯	喝醉了
喝人	骗人
红苕	红薯
黄司机	菜司机
黄司机	技术不好的司机
灰吧拢耸	全是灰
灰兜巴儿	垃圾堆
昏戳戳	晕乎乎
铲铲儿	锤子哦
铲铲儿	不信
搞铲铲儿哦	搞锤子哦
耙火	很软
耙火	便宜
捡耙火	捡便宜
伙起	出去浪
几娘母	几个女人
几爷子	几个大男人
假吧意思	假惺惺的
假吧意思	假装
假吧二三	假惺惺的
假精灵	纯粹小聪明
剪巴浪昂	口吃的人
将就	凑合
将就	勉强
焦人得很	非常着急
惊抓抓叻	一惊一乍的
精灵	聪明
精灵	机灵
九不干	拧不干
卡卡角角	犄角旮旯
砍脑壳的	挨千刀的
快当	快
快当	迅速
拉稀摆带	撂挑子
拉稀摆带	推卸责任
癞疙宝	癞蛤蟆
烂眼儿	小混混
街娃儿	小混混
不落教	不老实
不落教	不听话
妈卖批	你麻痹
马浪昂	蜻蜓
连八浪	蜻蜓
码不实在	弄不清楚
毛焦火辣	焦躁不安
毛了	非常生气
毛了	火大
惹毛了	惹火了
惹毛了	惹生气了
毛起	不要怂
雄起	不要怂就是干
茅丝	厕所
厕所	厕所
闷墩儿	壮实
拽实	壮实
莫得	没有
莫来头	没关系
不存在	没关系
不存在	没事儿
哪个	谁
恼火	严重
恼火得很	严重得很
恼火得很	很伤脑筋
好恼火哦	好累啊
好恼火哦	好严重啊
脑壳	头
脑壳	脑袋
闹热	热闹
你嘿起整嘛	你拼命干吧
你嘿实整嘛	你拼命做吧
你傍哈我告哈耶	你动动我试试
你傍哈我告哈耶	你动我一个试试
嬢嬢	阿姨
牛跳马板	指手画脚
弄饭	做饭
螃海	螃蟹
爬开	滚开
爬哦	我不信
帕子	手绢
帕子	毛巾
胖臭	很臭
批娃儿	小兔崽子
批娃儿	小王八蛋
批样子	逼样
撇脱	干脆
撇脱	洒脱
婆娘	老婆
婆娘	妻子
你要切哪儿	你要去哪儿
清不到	不管那么多
清口水长流	羡慕想吃
球鸡儿不懂干嚼劲	不懂装懂
球不冷疼	不务正业
无知哇优	不务正业
曲鳝儿	蚯蚓
黢黑八黑	很黑
曲球几码黑	很黑
可猫儿	青蛙
青蛙	青蛙
热火	暖和
扯霍闪	打闪
扯露水	下露
打白头霜	下很重的白霜
打霜	降霜
冷天	冬天
冬天	冬天
绵绵雨	连绵的阴雨
霖雨	梅雨
落雨	下雨
落雪	下雪
偏东雨	夏天阵雨
太阳坝里	太阳底下
天干	天旱
天气大	天气热
旋头风	旋风
阴凉坝	阴凉地儿
月亮坝	月亮照到的地方
太阳落难	日食
月亮落难	月食
坝	平地
沙坪坝	沙坪坝
坝坝	平地
坝子	平原
川西坝子	成都平原
成都平原	成都平原
凼凼	坑
水凼凼	水坑
发大水	发洪水
河坝	河滩
河坎	河岸
平坝	平地
乡坝头	乡下
乡下	乡下
堰塘	池塘
差黑	快黑
天差黑了	天快黑了
差黑	傍晚
大白大亮	天色大亮
二四八月	春秋两季
天粉粉亮	天色微明
天麻麻亮	天色微明
黑了	晚上
黑了看电视	晚上看电视
黑了打麻将	晚上打麻将
晚上打麻将	晚上打麻将
晚上	晚上
麻麻黑	快黑
麻麻黑	刚黑
天麻麻黑	天快黑
七月半	中元节
清早八晨	大清早
上半午	上午
上前年	大前年
上前天	大前天
晌午	中午
十冬腊月	冬天
望后天	大后天
五黄六月	夏天
下半天	下午
下午	下午
一哈儿	一会儿
一下儿	一会儿
一天到黑	从早到晚
月尾尾	月末
昨年子	去年
昨年	去年
去年	去年
耍把戏	耍杂技
半截子幺爸儿	半大小子
棒老二	强盗
棒客	强盗
兵哥子	当兵的
叉巴	轻浮
好叉巴	好轻浮
掸尖儿	说人坏话
掸尖儿	打小报告
操得好	混得好
操哥	流氓
扯横筋	耍横
炊二哥	炊事员
逮猫儿	嫖妓
逮猫儿	嫖娼
逮猫儿	躲猫猫
儿娃子	男孩子
男娃儿	男孩儿
女娃儿	女孩儿
二杆子	小流氓
费	调皮
街妹儿	街上的女流氓
街娃儿	街上的流氓
瓜	傻
瓜	呆
瓜瓜	傻瓜
瓜娃子	傻瓜
瓜娃子	呆子
哈	傻
哈儿	傻子
哈包儿	傻瓜
行势	吃得开
豁皮	霸王餐
恍	粗心
他恍得很	他粗心得很
恍恍	粗心大意的人
这人是个恍恍	这人是个粗心大意的人
尖	精明
尖	狡猾
这人好尖咯	这人好狡猾啊
尖脑壳	投机钻营的人
叫咕咕	蟋蟀
莽	憨
莽子	傻子
猫儿	妓女
猫	猫
摸哥儿	小偷
摸哥儿	扒手
摸摸匠	小偷
老果果	老手
老坎	土包子
咧肥	拍马屁
舔肥	拍马屁
耙耳朵	怕老婆的人
耙耳朵	妻管严
气管炎	妻管严
骚棒	下流男
骚棒	风骚男
骚鸡公	下流男
骚鸡公	风骚男
啬家子	吝啬鬼
死皮	死皮赖脸
收荒匠	拾荒者
天棒	胆大包天的人
瘟猪	笨蛋
囚皮汉	专爱纠缠女人的男人
涎皮搭脸	死皮赖脸
大大	父亲
爸爸	爸爸
弟娃儿	弟弟
哥老倌	哥哥
公	祖父
公	爷爷
爷爷	爷爷
家公	外公
家婆	外婆
外公	外公
外婆	外婆
老汉儿	父亲
插花	订婚
扯发票	领结婚证
吃咪咪	吃奶
出姓	改嫁
独丁丁	独生子女
双双儿	双胞胎
祝生	庆生
吃挂面	上吊
坐夜	守夜
坐夜	守灵
膀子	胳膊
背脊骨	脊椎骨
窜脸胡	络腮胡
倒拐子	手肘
对对眼儿	斗鸡眼儿
鼓鼓眼儿	眼睛突出
光巴斗儿	上身赤裸
喉咙管儿	喉咙
后脑壳儿	后脑勺儿
尽头牙	智齿
脚板儿	脚掌
脚杆	下肢
磕膝头儿	膝盖
脑门心	前额
溜肩膀	不负责任的人
他是个溜肩膀	他是个不负责任的人
臁二杆	小腿
螺丝骨	踝骨
盘盘儿	盘子
瞟眼儿	斜眼
手弯弯	手肘
牙巴	牙齿
摆龙门阵	闲聊
摆龙门阵	讲故事
拌脚板儿	步行
冲壳子	吹牛
打啵儿	接吻
打捶	打架
打空手	空着手
打梦脚	开小差
打偏偏	东偏西倒
打燃火	闹冲突
打甩手	空着手
点头啄脑	不断点头
勾腰驼背	弯腰驼背
脑壳勾倒	低头
揪飘飘儿	捏脸调戏
马起个脸	沉着个脸
马倒	欺负
马脸嘴	生气脸
埋头	低头
埋头	埋头
咬耳朵	说悄悄话
怕巴巴掌	鼓掌
跶了几个扑趴	摔了几个跟头
日噘	骂
日噘	调侃
涮坛子	瞎扯淡
不要张他	不要理他
不要张识他	不要理他
抓足球	踢足球
踢球	踢球
爪脚爪手	手脚不灵活
拽瞌睡	打瞌睡
半边风	半身不遂
半头房子	独眼龙
边花儿	独眼龙
不安逸	不舒服
扯嗝嗝儿	打嗝
扯母猪疯	癫痫
寸耳寒	腮腺炎
出麻子	患麻疹
打标枪	拉稀
倒欠皮	倒刺
吊盐水	输液
豆麻关	天花
过肚皮	腹泻
豁豁儿	豁嘴
豁豁儿	豁嘴的人
火把眼	结膜炎
齁巴儿	哮喘病人
夹舌头儿	大舌头
謇巴郎	大舌头
捡药	抓药
开仓	大口吐血
开单子	开药方
母猪疯	癫痫
青春籽	粉刺
缺嘴儿	唇腭裂
月间病	子宫内膜炎
撑花儿	伞
伞	伞
瓜瓢	大木瓢
烘笼	烘篮
皇桶	大木桶
糨子	浆糊
瓢羹儿	调羹
铺盖	被子
铺盖面子	被面
扫把	扫帚
手叉子	匕首
洗脸帕	洗脸巾
邹邹儿	塞子
扁	揍
抄手儿	馄饨
吃巴片儿	蹭饭
吃福喜	吃白食
吃抹合	吃白食
打平伙	AA制
打牙祭	打牙祭
担担面	担担面
当顿	当饭吃
豆花儿	豆腐脑
粉子	粉末
盖碗儿茶	盖碗儿茶
锅盔	锅盔
搅搅	糊糊
扣肉	烧白
毛豆腐	腐乳
毛毛菜	便宜的蔬菜
脷子	猪舌头
凉粉	凉粉
膀	猪肘子
泡泡肉	虚胖的肉
烧白	烧白
水盆鸡	水盆鸡
桃片	桃片
糖油果子	糖油果子
毛血旺	毛血旺
稀饭	米粥
香香	零食
醪糟	米酒
蒸蒸糕	蒸蒸糕
坐墩儿肉	猪臀肉
笆笆门	穷人家
板板门	富人家
插插	门闩
吊脚楼	吊脚楼
阳台	阳台
灶屋	厨房
背背裤	背带裤
叉叉裤	开裆裤
尿片片儿	尿布
夹袄	棉袄
帕帕儿	小帕子
手笼子	手套
手套	手套
滚滚儿	车轮
滚滚	熊猫
熊猫	熊猫
苞谷	玉米
撮箕	簸箕
点豆子	种豆子
谷子	稻子
姜苞儿	仔姜
酒米	糯米
莲花白	结球甘蓝
藤藤菜	空心菜
田坎	田埂
折耳根	鱼腥草
芭茅	芦苇
浮飘	浮萍
狗尾巴草	狗尾巴草
抠痒树	紫薇树
猫儿抓刺	贯叶蓼
癞疙宝草	雪见草
楼梯竹	芦竹
蜞蚂儿叶	车前草
桑泡儿	桑葚
爬壁虎儿	壁虎
丁丁猫儿	蜻蜓
牛牛儿	蜗牛
鬼灯哥	猫头鹰
叫咕咕	蝈蝈儿
筋斗虫	孑孓
毛狗	狐狸
癞疙宝	癞蛤蟆
老鸹	乌鸦
鲇巴郎	鲇鱼
雷公虫	蜈蚣
蜞蟆儿	青蛙
山耗子	田鼠
蛇太医	四脚蛇
梭老二	蛇
搜山狗	猎狗
土狗	蝼蛄
团鱼	甲鱼
乌棒	乌鱼
伢狗	公狗
伢猪	公猪
阳雀	杜鹃鸟
油炸蚂儿	蚱蜢
皂鸡子	蟋蟀
灶猫儿	蟑螂
赶场	赶集
白墨	粉笔
粉笔	粉笔
车笔刀	卷笔刀
读望天书	读书不专心
号卷子	评卷
进牛圈门	启蒙入学
零光蛋	零分
落尾巴儿	最后一名
鸭蛋	零分
端公	男巫
神婆子	女巫
跳端公	跳大神
吴二爷	无常鬼
办姑姑宴儿	过家家
帮腔	川剧伴唱
吹吹儿	哨子
倒糖人	做糖人
灯影戏	皮影戏
高脚狮子	高跷
牛牛儿	陀螺
梭梭板儿	滑梯
办席	摆酒席
办招待	请客
二麻二麻的	微醺
扯把子	撒谎
出脱	断送
捶	揍
打圈圈	转圈
打整	整理
打整	收拾
打转转	打转儿
点水	告密
嗲	嗲
拈砣砣	抓阄儿
看白	看不起
看白了	看清了
搁平	搞定
冒菜	冒菜
没得	没有
没搞	没戏
拉肥猪	绑票
排头	开头
跑滩	流浪
飘啥子	赌什么
啥子	什么
塞包袱	行贿
私曰	私了
说聊斋	作出交代
甩死耗子	失约
抖你一顿	揍你一顿
弯酸	刁难
稳起	沉住气
下烂药	说坏话
下烂药	出馊主意
香一个	亲一个
雄起	挺住
要得	可以
扎起	撑腰
展牙巴劲	斗嘴
占起手	占优势
罢脚货	劣等品
刀儿匠	屠夫
道道儿	道士
颠颠儿	尖尖儿
吊话	牢骚话
二话	牢骚话
纸飞飞	纸屑
果子泡儿	大水泡
过场	名堂
旱鸭子	不会游泳的人
火色	火候
黄话	横话
黄腔	外行话
黄师傅	门外汉
筋筋网网	破破烂烂
冲壳子	吹牛
让手	退让的余地
索索	绳子
甩甩话	模棱两可的话
推口话	借口
歪名	外号
歪名	绰号
闲条	闲话
洋盘货	时髦的东西
打眼	惹人注意
得行	能干
对头	正确
对头	合适
二通二通	半通不通
疯扯扯	疯疯癫癫
胡二麻子	糊里糊涂
卡白	惨白
肉扯扯	不果断
塞边打网	无关紧要
四楞四现	棱角分明
死木呆呆	死气沉沉
苏气	漂亮
这姑娘好苏气	这姑娘好漂亮
忘命	不顾生命
心欠欠	心里还不满足
周正	整齐
周围团转	周围
别个	别人
各人做各人的	自己做自己的
哪百年	什么时候
哪个	谁
哪个的书	谁的书
哪哈儿	什么时候
哪门	怎么
想吃哪样	想吃什么
想耍哪样	想玩什么
那哈儿	那时
那们	那样
啷个	怎么
浪个	那个
啷们	怎么
恁个	这么个
样啥都没有	什么都没有
咋	怎么
咋个	怎么
咋个样	怎么样
这们	这么
你啷个这们浪个哎	你怎么这么那个哎
丁丁儿	一点点
跟倒	立刻
寡晓得说	只知道说
怪死难看	非常难看
怪死难吃	非常难吃
架势笑	使劲地笑
将将上课	刚刚上课
将将合适	刚刚合适
幸得好	幸好
喜得好	幸好
挨倒我坐	靠近我坐
半夜吃桃子	欺负弱小
壁头上挂团鱼	四脚无靠
城隍庙的瓜槌	一丘之貉
吃得亏打得堆	不怕吃亏的人好相处
刺芭林的斑鸠	不知春秋
丁丁猫儿变的	不要脸的
牛胯扯到马胯	风马牛不相及
猫儿抓糍粑	脱不了干系
让子弹飞一哈儿	让子弹飞一会儿
不急跟他耍耍	不急跟他玩玩儿
算逑	算了
马县长此番风度正好比	马县长此番风度正好比
大风起兮云飞扬	大风起兮云飞扬
写首丝	写首诗
要有风要有肉	要有风要有肉
要有火锅要有雾	要有火锅要有雾
要有美女儿要有驴	要有美女要有驴
脑壳搬家	脑袋搬家
莫客气嘛	别客气嘛
我晓得你喜欢花姐	我知道你喜欢花姐
日妈很丢人	妈的很丢人
那你是想站到	那你是想站着
还是想挣钱嘛	还是想挣钱嘛
我是想站到还把钱挣咯	我是想站着还把钱挣了
挣逑不成	挣不成
公平	公平
还是TM的公平	还是TM的公平
听到像穆扎	听着像穆扎
他们那边叫穆扎	他们那儿叫穆扎
咱们这里叫莫扎特	咱们这里叫莫扎特
小凤仙都晓不得还当妓女	小凤仙都不知道还当妓女
那可是名震京城誉满全国的鸡	那可是名震京城誉满全国的妓
我以为	我以为
酒一口一口喝	酒一口一口喝
路一步一步走	路一步一步走
步子迈大了	步子迈大了
容易扯到蛋	容易扯着蛋
起了个东洋名字	起了个东洋名字
黛玉晴雯子	黛玉晴雯子
有了腿便有了路	有了腿便有了路
师爷高	师爷高
县长硬	县长硬
黄老爷又高又硬	黄老爷又高又硬
不好色的县长不一定是好县长	不好色的县长不一定是好县长
你是要杀我还是要睡我	你是要杀我还是要睡我
我要睡你	我要睡你
那你还是杀了我嘛	那你还是杀了我吧
世界上本没有路	世界上本没有路
今天	今天
今天吃啥子	今天吃什么
如果你活着	如果你活着
早晚都会死	早晚都会死
如果你死了	如果你死了
你就永远活着	你就永远活着
你给我他妈的翻译一下	你给我他妈的翻译一下
他妈的到底什么是他妈的惊喜	他妈的到底什么是他妈的惊喜
你在抓子	你在干嘛
你抓子老	你怎么了
他们总说我瓜	他们总说我傻
其实我一点儿也不瓜	其实我一点儿也不傻
他们总说我瓜	他们总说我笨
其实我一点儿也不瓜	其实我一点儿也不笨
大多时候我都机智的一逼	大多时候我都机智的一逼
不要叫宝儿姐	不要叫宝儿姐
要叫主人	要叫主人
没得事	没事
交给我	交给我
我弄死他们	我弄死他们
在别人面前尽管装	在别人面前尽管装
今后姐罩着你	今后姐罩着你
跟他们装装逼可以	跟他们装装逼可以
跟我装	跟我装
弄死你	弄死你
叫啥子叫	叫什么叫
之前不是说了吗	之前不是说了吗
有姐罩着你呢	有姐罩着你呢
那个啥子	那个什么
小师叔	小师叔
打狗还要看主人呢	打狗还要看主人呢
你要是再继续的话	你要是再继续的话
我就是你的对手	我就是你的对手
他会有多爱你	他会有多爱你
才会给你取名叫宝宝	才会给你取名叫宝宝
张楚岚	张楚岚
不用怕他	不用怕他
一个区区天师府的小辈而已	一个区区天师府的小辈而已
做了姐的奴隶	做了姐的奴隶
你就不用再隐藏或者逃避了	你就不用再隐藏或者逃避了
不想再趴着活	不想再趴着活
就堂堂正正的站起来	就堂堂正正的站起来
把找你麻烦的	把找你麻烦的
全部都打回来	全部都打回来
胖达荣荣来也	胖子绒绒来了
火锅好吃刀下留人	火锅好吃刀下留人
火锅	火锅
我的脸谱喃	我的脸谱喃
生平最爱吃	生平最爱吃
我不做了	我不做了
好黑人哦	好吓人哦
嗨在下胖达绒绒	嗨在下胖子绒绒
嘿哟站住	嘿哟站住
失手咯	失手咯
好胖好胖球球最乖	好胖好胖球球最乖
想拜我为师不	想拜我为师不
绒绒送你回家泡温泉	绒绒送你回家泡温泉
绒绒不要那个	绒绒不要那个
啥子哟	什么啊
呜呜呜	呜呜呜
有个锤子	有个屁
莫得	没有
有个锤子的锤子	有个屁的锤子
有个铲铲	有个屁
砸个锤子的窗子	砸个屁的窗子
哎呀我跟你说个锤子	哎呀我跟你说个屁
有个毛线	有个屁
你是啥子鸟哦	你是什么鸟哦
我是凤凰噻	我是凤凰啊
哪有你龟儿子这么黑的凤凰哦	哪有你这么黑的凤凰哦
你晓得个铲铲	你知道个屁
各位乘客	各位乘客
飞机遭出问题老	飞机出现问题了
浪个搞的嘛	怎么搞的嘛
我们先杀到天安门	我们先赶到天安门
然后再杀到中南海	然后再赶到中南海
要得	好的
我们就按到你说的路线一路杀过切嘛	我们就按照你说的路线一路赶过去嘛
你浪个不开腔	你怎么不说话
你都不开腔	你都不说话
我浪个敢开耶	我怎么敢说话呢
勒哈安逸了	这下舒服了
包包都遭整空了	包包都被搞没钱了
哪儿去搞点子弹嘛	哪儿去取点钱嘛
熊猫坐飞机	飞宝
熊猫坐斗斗车	抖宝
不管白猫黑猫	不管白猫黑猫
捉到耗子就是好猫	抓到耗子就是好猫
开黄腔	说瞎话
开黄腔	说外行话
不懂就不要乱开黄腔	不懂就不要乱说瞎话
耍女朋友	找女朋友
洋盘	拉风
洋盘	洋气
算逑	算了
在四川有一种放弃叫算逑	在四川有一种放弃叫算了
他的话算个逑啊听我的	他的话算个屁啊听我的
背时	活该
该背时	活该
背时	倒霉
今天好背时哦	今天好倒霉哦
你懂个铲铲	你懂个锤子
你躲在那里爪子	你躲在那里干嘛
爪子	干嘛
哦豁	完了
哦豁屋里遭贼了	完了屋里遭贼了
猫儿抓糍粑	脱不了爪爪
搞锤子	玩蛇
宝器	傻瓜
刀刀客	强盗
肉嘎嘎	肉
吃嘎嘎	吃肉肉
光胴胴	裸上身
鱼摆摆	鱼
捉贼娃子	抓贼
雄起	加油
你吃饭没得	你吃饭没有
不摆了	无话可说
过场多	把戏多
马了个巴子	去尼马个比
耍朋友	谈恋爱
雀雀儿	小鸟
莽戳戳	傻乎乎
老子明天不上班	我明天不上班
兔儿	兔子
兔儿	兔兔
四川人每年吃掉3亿只兔儿	四川人每年吃掉3亿只兔兔
麻辣兔头	麻辣兔头
双椒兔	双椒兔
酸菜火锅兔	酸菜火锅兔
冷吃兔	冷吃兔
兔火锅	兔火锅
兔儿脑壳	兔头
麻辣兔头	兔兔的花里胡哨吃法
不辣的兔头都是异端	不辣的兔头都是异端
你个瓜娃子	你个傻瓜
啃过兔儿脑壳麦	啃过兔头吗
啃兔脑壳	接吻
飞禽莫如鸽走兽莫如兔	飞禽莫如鸽走兽莫如兔
干锅兔	干锅兔
红烧兔	红烧兔
尖椒兔	尖椒兔
烤兔	烤兔
麻辣兔丁	麻辣兔丁
手撕兔	手撕兔
烟熏兔	烟熏兔
迷到脑壳整	闷头干
巴适得板	舒服得很
不得虚	不会怕
不要虚	不要怂
哈哈儿	一会儿
哈哈儿	马上
假老练和风车车	猫和老鼠
你呢个瓜猫儿	你这个傻猫
今晚我又来到你的窗前	今晚我又来到你的窗前
今天天气好好哇	今天天气好好哇
春光明媚	春光明媚
假老练回来了	汤姆回来了
对面的母猫看过来	对面的母猫看过来
看过来	看过来
这边的公猫长得黑帅	这边的公猫长得很帅
求求你一定	求求你一定
咋个莫得反应讷	怎么没有反应呢
风车车	杰瑞
假老练	汤姆
假老练你在看撒子哦	汤姆你在看啥呢
我切看一哈	我去看一下
春春	春春
你是我的心	你是我的心
你是我的肝	你是我的肝
你是我的四昏之三	你是我的四分之三
莫得人陪你耍了	没人陪你玩儿了
假老练陪我去耍下子嘛	汤姆陪我去玩儿会儿吧
爬开点哈	滚远点哈
看啥子看	看什么看
悄悄咪咪	轻轻
走瓜了	走了
悄悄咪咪儿地我走瓜了	轻轻的我走了
就像我悄悄咪咪儿地梭起来	正如我轻轻的来
我轻轻的甩一哈手杆	我轻轻的招手
跟天边那坨云说拜拜	作别西天的云彩
那河边的金柳	那河畔的金柳
是夕阳中的新娘	是夕阳中的新娘
波浪里头的影影儿	波光里的艳影
在我心口头打璇璇儿	在我的心头荡漾
软泥上的青荇	软泥上的青荇
滑不溜揪的在水头乱板	油油的在水底招摇
在康河的柔波里	在康河的柔波里
我巴不得是那一颗海草	我甘心做一条水草
那树荫下的一潭	那树荫下的一潭
不是清泉是天上虹	不是清泉是天上虹
在河草头遭揉得稀烂	揉碎在浮藻间
沉淀着彩虹似的梦	沉淀着彩虹似的梦
寻梦	寻梦
撑一支长篙	撑一支长篙
向青草更青处漫溯	向青草更青处漫溯
装满了一船星星的月光儿	满载一船星辉
在星辉斑斓里毛起吼	在星辉斑斓里放歌
但我不能毛起吼	但我不能放歌
悄悄是别离的笙箫	悄悄是别离的笙箫
夏虫也在边上腔都不开	夏虫也为我沉默
沉默是今晚的康桥	沉默是今晚的康桥
悄悄咪咪的我走瓜了	悄悄的我走了
就像我悄悄咪咪的唆起来	正如我悄悄的来
我挥一挥衣袖	我挥一挥衣袖
不带走一片云彩	不带走一片云彩
花	花
草	草
树木	树木
姐姐	姐姐
姐	姐
嗨	嗨
你好	你好
你用跑的	你用跑的
等哈儿	等等
让我来	让我来
我赢老	我赢了
不会吧	不会吧
干杯	干杯
你懂起没	你懂了吗
懂起	懂了
你懂起没得	你懂了没有
他跑老	他跑了
跳进来	跳进来
我迷失老	我迷失了
我退出	我退出
我没得事	我没事
听倒	听着
你给我听倒起	你给我听着
不可能	不可能
没门	没门
你确定	你确定
试试噻	试试吧
告一哈	试一下
我们来试试	我们来试试
我们来告一哈	我们来试试
为啥子是我	为什么是我
切问他	去问他
冷静点	冷静点
公平点	公平点
友善点	友善点
和气点	和气点
联系我	联系我
联系我们	联系我们
进来	进来
找到他	找到他
滚出切	滚出去
出切	出去
走开	走开
滚	滚
再见	再见
告辞	告辞
等一哈	等一下
他来老	他来了
他跑	他跑
帮我一哈	帮我一下
帮帮我们吧	帮帮我们吧
坚持	坚持
抱抱他	抱抱他
我同意	我同意
我生病老	我生病了
我老老	我老了
没关系	没关系
没来头	没关系
是我	是我
来加入我们吧	来加入我们吧
留着吧	留着吧
吻我	吻我
完美	完美
闭嘴	闭嘴
把嘴巴闭倒	把嘴闭上
不管它	不管它
拿走吧	拿走吧
醒醒	醒醒
切清洗一哈	去清洗一下
我们晓得	我们知道
欢迎	欢迎
哪个赢老	谁赢了
为啥子不	为什么不
你跑	你跑
往后退点	往后退点
静静的莫动	静静的别动
我一无所知	我一无所知
把他铐上	把他铐上
把他铐倒	把他铐上
往前开	往前开
趴下	趴下
醒醒吧	醒醒吧
干的好	干的好
抓住汤姆	抓住汤姆
抓住他	抓住他
耍得开心	玩得开心
他来试试	他来试试
你就随老我的意嘛	你就随了我的意吧
赶快	赶快
搞快	赶快
快点	快点
我忘老	我忘了
我放弃	我放弃
我来付钱	我来付钱
我很忙	我很忙
我冷	我冷
我很好	我很好
我吃饱老	我吃饱了
我病老	我病了
我个子高	我个子高
让我一个人呆哈儿	让我一个人呆会儿
走嘛	走吧
我们开始嘛	我们开始吧
我们走嘛	我们走吧
当心	当心
她跑	她跑
起立	起立
他们赢老	他们赢了
汤姆切世老	汤姆去世了
汤姆不干老	汤姆不干了
汤姆游泳老	汤姆游泳了
相信我	相信我
努力	努力
告一哈嘛	试试吧
哪个死老	谁死了
鸟类飞行	鸟类飞行
打电话回家	打电话回家
抓到他	抓住他
回家吧	回家吧
现在就做	现在就做
狗会叫	狗会叫
莫哭	别哭
对不起	对不起
来感受一哈这个	来感受一下这个
请跟我来	请跟我来
请跟倒我们	请跟着我们
祝你好运	祝你好运
抓到那个	抓住那个
抓到这个	抓住这个
手举起来	手举起来
他是一个DJ	他是一个DJ
他很懒	他很懒
停火	停火
我住这儿	我住这儿
太可怕老	太可怕了
我没事	我没事
我老解你	我了解你
我希望如此	我希望如此
我笑老	我笑了
我向你保证	我向你保证
我看见汤姆老	我看见汤姆了
我要游泳	我要游泳
我是个男人	我是个男人
我是对的	我是对的
我很抱歉	我很抱歉
我还年轻	我还年轻
远吗	远吗
下雪老	下雪了
3点半老	3点半了
天很冷	天很冷
它是免费的	它是免费的
很晚老	很晚了
这是真的	这是真的
让我进切	让我进去
躺倒不动	躺着不动
回头看	回头看
腾一哈地方	腾一下地方
当然	当然
当然老	当然了
噢拜托老	噢拜托了
开火	开火
念这个	念这个
参见上文	参见上文
她哭老	她哭了
她试过老	她试过了
她在行走	她在行走
耐心等倒	耐心等着
慢一点	慢一点
保持冷静	保持冷静
趴倒	趴着
住手	住手
照顾好自己	照顾好自己
汤姆睡老	汤姆睡了
Tom游泳	Tom游泳
汤姆累老	汤姆累了
汤姆挥手老	汤姆挥手了
汤姆要走	汤姆要走
向左转	向左转
在这等倒	在这等着
做得好	做得好
爱哪个哪个	爱谁谁
哪个	谁
很棒	很棒
蠢货	蠢货
你身上发臭老	你身上发臭了
请上船	请上船
我错老吗	我错了吗
鸟儿歌唱	鸟儿歌唱
我可以帮忙吗	我可以帮忙吗
必须的	必须的
莫动	别动
莫动	不要动
把它填满	把它填满
跟倒他走	跟着他走
上帝存在	上帝存在
晚安	晚安
他让步老	他让步了
他很歪	他很凶
他很穷	他很穷
他高	他高
你好汤姆	你好汤姆
嘿放松点	嘿放松点
多可爱啊	多可爱啊
赶快回家	赶快回家
我个头矮	我个头矮
我会做饭	我会做饭
我会游泳	我会游泳
我不能走	我不能走
我在这里吃	我在这里吃
我嫉妒她	我嫉妒她
我羡慕他	我羡慕他
我恨你	我恨你
我认识汤姆	我认识汤姆
我认识他	我认识他
我喜欢茶	我喜欢茶
我喜欢你	我喜欢你
我爱她	我爱她
我爱您	我爱您
我想念他	我想念他
我想念你	我想念你
我需要你	我需要你
我想是这样的	我想是这样的
我使用这个	我使用这个
我会做的	我会做的
我是个英雄	我是个英雄
我是谦虚的	我是谦虚的
我单身	我单身
我困老	我困了
我好胖哦	我好胖哦
莫理汤姆	别理汤姆
那是爱吗	那是爱吗
真是太好老	真是太好了
是晚上老	是晚上了
放松点嘛	放松点吧
保持安静	保持安静
让他进来	让他进来
让我切死	让我去死
让我想一想	让我想一想
我们走走嘛	我们走走吧
看那里	看那里
禁止评论	禁止评论
无可奉告	无可奉告
莫问题	没问题
莫关系	没关系
噢真的吗	噢真的吗
再一次	再一次
她笑老	她笑了
往后站	往后站
保持警惕	保持警惕
留倒这里莫动	留在这里别动
让开	让开
好好学习	好好学习
真疼	真疼
时光飞逝	时光飞逝
时间匆匆走过	时间匆匆走过
汤姆害羞	汤姆害羞
汤姆笑老	汤姆笑了
汤姆打哈欠老	汤姆打哈欠了
向右转	向右转
我们笑老	我们笑了
我们失切老它	我们失去了它
这是啥子啊	这是什么啊
有啥子新鲜事吗	有什么新鲜事吗
我在哪里	我在哪里
这是啥子地方	这是什么地方
我们是哪个	我们是谁
下一个是哪个	下一个是谁
木材燃烧	木材燃烧
我们完成老吗	我们完成了吗
你是汤姆吗	你是汤姆吗
您生气老吗	您生气了吗
你生气老吗	你生气了吗
你伤心吗	你伤心吗
友好点	友好点
停手	停手
你能看吗	你能看吗
算我一个	算我一个
按我说的做	按我说的做
莫走	别走
不要恐慌	不要恐慌
不许大叫	不许大叫
莫担心	别担心
认真点	认真点
他独自一人	他独自一人
他醉老	他醉了
他很强壮	他很强壮
我们到老	我们到了
这里快抓住	这里快抓住
你们好吗	你们好吗
你好吗	你好吗
多怪啊	多怪啊
真奇怪	真奇怪
我来老	我来了
我买磁带	我买磁带
我不能说	我不能说
我不扯把子	我不说谎
我吃面包	我吃面包
我觉得冷	我觉得冷
我感觉很好	我感觉很好
我感到虚弱	我感到虚弱
我有时间	我有时间
我听你的	我听你的
我喜欢鱼	我喜欢鱼
我喜欢爵士乐	我喜欢爵士乐
我喜欢他们	我喜欢他们
我住在这	我住在这
我需要胶水	我需要胶水
我需要帮助	我需要帮助
我睡过头老	我睡过头了
我是那样说的	我是那样说的
我闻到瓦斯味	我闻到瓦斯味
我信任他	我信任他
我信任你	我信任你
我想要更多	我想要更多
我搞错老	我搞错了
我会听从指示	我会听从指示
我会等	我会等
我在这里工作	我在这里工作
我会参加	我会参加
我会进切	我会进去
我也是17岁	我也是17岁
我是个不成器的人	我是个不成器的人
我在家	我在家
我很好奇	我很好奇
我结婚老	我结婚了
我已婚	我已婚
我在读书	我在读书
我是认真的	我是认真的
我渴老	我渴了
汤姆还好吧	汤姆还好吧
这是你的吗	这是你的吗
这不可能	这不可能
这是我份内的事	这是我份内的事
只要说不	只要说不
继续努力	继续努力
让我晓得	让我知道
让我们开始嘛	让我们开始吧
人生是有趣的	人生是有趣的
四处看看	四处看看
午餐送到老	午餐送到了
非常感谢	非常感谢
金钱万能	金钱万能
好时机	好时机
莫得人来老	没有人来了
好我同意	好我同意
请来吧	请来吧
请唱歌	请唱歌
放开他	放开他
她打老他	她打了他
一边站倒	一边站着
这就是生活	这就是生活
人生就是如此	人生就是如此
这很软	这很软
他们拥抱	他们拥抱
他们亲吻老	他们亲吻了
这是冰块	这是冰块
汤姆脸红老	汤姆脸红了
汤姆皱着眉头	汤姆皱着眉头
汤姆变胖老	汤姆变胖了
汤姆看见你老	汤姆看见你了
汤姆会等	汤姆会等
汤姆错老	汤姆错了
转过来	转过来
等哈我	等等我
我们是男娃	我们是男孩
我们迟到老	我们迟到了
我们都赢老	我们都赢了
我们可以休息	我们可以休息
我们认识他	我们认识他
我们爱汤姆	我们爱汤姆
我们想要汤姆	我们想要汤姆
我们要一个	我们要一个
太可惜老	太可惜了
多遗憾啊	多遗憾啊
那是啥子	那是什么
这是啥子	这是什么
你是哪个	你是谁
哪个画的	谁画的
那是哪个	那是谁
这是哪个的	这是谁的
木头会漂浮	木头会漂浮
干活慢点	干活慢点
你在这里	你在这里
你有病	你有病
你忙吗	你忙吗
您在忙吗	您在忙吗
您迷路老吗	您迷路了吗
你迷路老吗	你迷路了吗
你确定吗	你确定吗
现实点	现实点
带他进来	带他进来
现在给汤姆打电话	现在给汤姆打电话
我们能做到吗	我们能做到吗
你能来吗	你能来吗
你能阅读吗	你能阅读吗
你会游泳吗	你会游泳吗
你打过电话老吗	你打过电话了吗
你吸烟吗	你吸烟吗
您吸烟吗	您吸烟吗
尽力而为	尽力而为
莫伤心	别伤心
不要害羞	不要害羞
不用麻烦老	不用麻烦了
莫来烦我	别来烦我
安全地驾驶	安全地驾驶
开车慢点	开车慢点
鬼魂是存在的	鬼魂是存在的
还回切	还回去
晚上好	晚上好
早上好	早上好
他生气老	他生气了
他有辆车	他有辆车
他喜欢茶	他喜欢茶
他爱她	他爱她
他很勇敢	他很勇敢
他现在出切老	他现在出去了
真烦人	真烦人
你敢	你敢
真糟糕	真糟糕
我欣赏你	我欣赏你
我几乎赢老	我几乎赢了
我在祈祷	我在祈祷
我吃老鱼子酱	我吃了鱼子酱
我给汤姆打老电话	我给汤姆打了电话
我走不老	我走不了
我无所谓	我无所谓
我有一辆车	我有一辆车
我有一条狗	我有一条狗
我有一张地图	我有一张地图
我喜欢豆子	我喜欢豆子
我喜欢这些	我喜欢这些
我爱音乐	我爱音乐
我想你	我想你
我看到一本书	我看到一本书
我明白老	我明白了
我想要一只狗	我想要一只狗
我要告你	我要告你
我洗耳恭听	我洗耳恭听
我在流血	我在流血
我现在有空老	我现在有空了
我是清白的	我是清白的
我是新来的	我是新来的
我没在忙	我没在忙
我不确定	我不确定
我怀孕老	我怀孕了
我好高兴	我好高兴
我好累	我好累
我饿死老	我饿死了
我饿死老	我饿死了
我是最好的	我是最好的
我激动不已	我激动不已
我决定老	我决定了
真的	真的
太神奇老	太神奇了
它是明显的	它是明显的
下雨老	下雨了
在下雨	在下雨
正在下雪	正在下雪
太难老	太难了
它太大老	它太大了
继续看	继续看
继续工作	继续工作
让我想一哈	让我想一想
我们现在切嘛	我们现在去吧
人生会继续	人生会继续
玛丽进来老	玛丽进来了
玛丽很高	玛丽很高
我现在能切老吗	我现在能去了吗
轻轻地移动	轻轻地移动
我的眼睛痛	我的眼睛痛
莫得人知道	没有人知道
没人问过	没人问过
打开箱子	打开箱子
请抓紧时间	请抓紧时间
请你离开	请你离开
一哈儿见	一会儿见
到时候见	到时候见
你真丢脸	你真丢脸
她很安静	她很安静
她心情不好	她心情不好
她可以来	她可以来
她也许来	她也许来
有人来老	有人来了
你说话小点声	你说话小点声
和我们留在一起吧	和我们留在一起吧
莫再傻看倒	别再傻看着
莫再念老	别再念了
莫再盯倒老	别再盯着了
不要说话老	不要说话了
莫再埋怨老	别再埋怨了
莫再喊叫老	别再喊叫了
祝你好梦	祝你好梦
放轻松	放轻松
莫紧张	别紧张
带我回家	带我回家
告诉我们多一点	告诉我们多一点
那是我的	那是我的
那是疯狂的	那是疯狂的
那真是太好老	那真是太好了
对	对
他们拒绝老	他们拒绝了
它们是假的	它们是假的
这是我的	这是我的
汤姆跟倒	汤姆跟着
汤姆是干净的	汤姆是干净的
汤姆高兴	汤姆高兴
Tom认识我	Tom认识我
汤姆坐下老	汤姆坐下了
汤姆告诉老他	汤姆告诉了他
汤姆饱老	汤姆饱了
汤姆快起来	汤姆快起来
再试一次	再试一次
再告一哈	再试一次
难以置信	难以置信
投票给汤姆	投票给汤姆
走着瞧	走着瞧
我们很快乐	我们很快乐
我们能开始	我们能开始
我们需要更多	我们需要更多
我们成功老	我们成功了
我们投降	我们投降
我们已是成年人老	我们已是成年人了
我们在藏着	我们在藏着
欢迎回来	欢迎回来
爱是啥子	爱是什么
那是啥子啊	那是什么啊
这是哪个建的	这是谁建的
哪个来老这里	谁来了这里
多少年过切老	多少年过去了
你喝醉老	你喝醉了
还有别的吗	还有别的吗
你快乐吗	你快乐吗
您准备好老吗	您准备好了吗
你们准备好老吗	你们准备好了吗
你准备好老吗	你准备好了吗
你累老吗	你累了吗
带钥匙来	带钥匙来
叫保安来	叫保安来
你会溜冰吗	你会溜冰吗
请结帐	请结帐
不要放弃	不要放弃
画一个圈	画一个圈
鲜花盛开	鲜花盛开
他不会游泳	他不会游泳
这是一个小偷	这是一个小偷
他在家里	他在家里
他是我的菜	他是我的菜
他不是哈儿	他不是傻子
他没疯	他没疯
他欺骗老我们	他欺骗了我们
他卖车子	他卖车子
他枪击老我	他枪击了我
他努力地尝试	他努力地尝试
他想要更多	他想要更多
他不在家	他不在家
他在读书	他在读书
你咋咯样	你怎么样
那你呢	那你呢
你们呢	你们呢
您呢	您呢
多美啊	多美啊
我离婚老	我离婚了
我很难过	我很难过
我同意它	我同意它
我相信你	我相信你
我信过你	我信过你
我看得见汤姆	我看得见汤姆
我无法做到这一点	我无法做到这一点
我做不到	我做不到
我鄙视你	我鄙视你
我确实看见他老	我确实看见他了
我没通过	我没通过
我餵过狗老	我餵过狗了
我觉得很孤独	我觉得很孤独
我感觉不安逸	我感觉不舒服
我是免费得到的	我是免费得到的
我有一个家	我有一个家
我有一只蛋	我有一只蛋
我必须赢	我必须赢
我喜欢运动	我喜欢运动
我喜欢甜食	我喜欢甜食
我喜欢吃	我喜欢吃
我喜欢跑步	我喜欢跑步
我爱咖啡	我爱咖啡
我爱电影	我爱电影
我爱大自然	我爱大自然
我想念波士顿	我想念波士顿
我现在必须走老	我现在必须走了
他需要一件外套	他需要一件外套
我需要些建议	我需要些建议
我需要尝试	我需要尝试
我尊敬汤姆	我尊敬汤姆
我应该服从	我应该服从
我想我可以	我想我可以
我想哭	我想哭
我想死	我想死
我刚才在家	我刚才在家
我很冷	我很冷
我要买这个	我要买这个
我会打电话给你	我会打电话给你
我会在这里吃饭	我会在这里吃饭
我会切接他的	我会去接他的
我是个学生	我是个学生
我是个老师	我是个老师
我累死老	我累死了
困死老	困死了
我在节食	我在节食
我这就上路	我这就上路
我真蠢	我真蠢
我有酒	我有酒
严重吗	严重吗
看起来不错	看起来不错
可能会下雨	可能会下雨
可能要下雨老	可能要下雨了
它是个秘密	它是个秘密
公事公办	公事公办
天气好冷	天气好冷
它有改善老	它有改善了
我请客	我请客
不是我的	不是我的
它太长老	它太长了
它太大声	它太大声
它很大	它很大
确保汤姆安全	确保汤姆安全
让我看看	让我看看
锁大门	锁大门
我可以进来吗	我可以进来吗
在那里见我	在那里见我
我的脚痛	我的脚痛
我的钢笔是新的	我的钢笔是新的
决不放弃	决不放弃
量力而行	量力而行
戒掉赌博吧	戒掉赌博吧
现在读这个	现在读这个
拯救你自己	拯救你自己
和我握手	和我握手
我们该步行吗	我们该步行吗
她感到闷闷不乐的	她感到闷闷不乐的
她恨他	她恨他
她爱汤姆	她爱汤姆
她在节食中	她在节食中
她在节食	她在节食
她是我的菜	她是我的菜
给我看哈它吧	给我看下它吧
不要把门开着	不要把门开着
关门	关门
坐我旁边	坐我旁边
讲清楚	讲清楚
搅一哈汤	搅一下汤
别再插手	别再插手
停止射击	停止射击
改邪归正	改邪归正
事情难免会发生	事情难免会发生
重新告诉我	重新告诉我
还是要说谢谢的	还是要说谢谢的
那是一本书	那是一本书
铃响老	铃响了
他们有带武器	他们有带武器
这是假发	这是假发
时间就是金钱	时间就是金钱
今天很有趣	今天很有趣
汤姆回来老	汤姆回来了
汤姆没走	汤姆没走
汤姆是个乡巴佬	汤姆是个乡巴佬
汤姆缺席	汤姆缺席
汤姆是个无聊的人	汤姆是个无聊的人
汤姆非常性感	汤姆非常性感
汤姆不老	汤姆不老
汤姆认识他	汤姆认识他
汤姆爱你	汤姆爱你
汤姆睡过头老	汤姆睡过头了
汤姆跑得快	汤姆跑得快
汤姆被解僱老	汤姆被解僱了
请稍等	请稍等
我们必须走老	我们必须走了
我们保持老沉默	我们保持了沉默
我们喜欢音乐	我们喜欢音乐
我们想你	我们想你
我们需要钱	我们需要钱
我们明白	我们明白
我们想要糖	我们想要糖
我们感到厌烦老	我们感到厌烦了
我们会很忙	我们会很忙
我们会切做	我们会去做
我们是特别的	我们是特别的
我们很特别	我们很特别
我们很担心	我们很担心
我们已经到老	我们已经到了
您当时在忙吗	您当时在忙吗
你在哪儿	你在哪儿
哪个帮帮她	谁帮帮她
这是哪个的	这是谁的
为啥子责备汤姆	为什么责备汤姆
你在扯谎	你在撒谎
你能跑	你能跑
你看起来很苍白	你看起来很苍白
你应该切	你应该去
你最好切	你最好去
你会失败	你会失败
你工作努力	你工作努力
你在开玩笑吧	你在开玩笑吧
你真坏	你真坏
鸟会飞	鸟会飞
请允许我切	请允许我去
你在哭吗	你在哭吗
你不是汤姆吗	你不是汤姆吗
你不热吗	你不热吗
对她好点	对她好点
鸟下蛋	鸟下蛋
把水烧开	把水烧开
把它带给我	把它带给我
我可以吃这个吗	我可以吃这个吗
我能帮你吗	我能帮你吗
我能坐这里吗	我能坐这里吗
你能起床吗	你能起床吗
打扫房间	打扫房间
我要咖啡谢谢	我要咖啡谢谢
牛可产奶	牛可产奶
解决他们	解决他们
我们认识你么	我们认识你么
你认识我吗	你认识我吗
你还认识我吗	你还认识我吗
你喜欢吗	你喜欢吗
你想我老	你想我了
你想我吗	你想我吗
你保证吗	你保证吗
你保证	你保证
莫碰它	别碰它
每个人都会扯把子	每个人都会说谎
狐狸吃母鸡	狐狸吃母鸡
起床	起床
下午好	下午好
新年快乐	新年快乐
你该多吃点	你该多吃点
他提速老	他提速了
他快死老	他快死了
他把我们弄糊涂老	他把我们弄糊涂了
他不扯谎	他不说谎
他举办老一场舞会	他举办了一场舞会
他是美国人	他是美国人
他一个人生活	他一个人生活
他独自生活	他独自生活
他看起来很年轻	他看起来很年轻
他弄丢老一本书	他弄丢了一本书
他唱老一首歌	他唱了一首歌
他卖水果	他卖水果
他被淹死老	他被淹死了
他溺水而亡	他溺水而亡
他是个大男孩	他是个大男孩
他是作家	他是作家
这里有一本书	这里有一本书
它多贵	它多贵
多少钱	多少钱
我是匈牙利人	我是匈牙利人
我今天休息	我今天休息
我太矮老	我太矮了
我相信老你	我相信了你
我借钱	我借钱
我的手臂断老	我的手臂断了
我不懂	我不懂
我切学校	我去学校
我被逮捕老	我被逮捕了
我起床早	我起床早
我有一个设想	我有一个设想
我有一个愿景	我有一个愿景
我讨厌星期一	我讨厌星期一
我咳嗽	我咳嗽
我有一个梦想	我有一个梦想
我打嗝老	我打嗝了
我没时间	我没时间
我经常打嗝	我经常打嗝
我喜欢画画	我喜欢画画
我喜欢花	我喜欢花
我喜欢阅读	我喜欢阅读
我爱我的生活	我爱我的生活
我爱我的生命	我爱我的生命
我爱我的妻子	我爱我的妻子
我爱派对	我爱派对
我遇见一个朋友	我遇见一个朋友
我需要一张邮票	我需要一张邮票
我尽快需要	我尽快需要
我需要我的大衣	我需要我的大衣
我需要知道	我需要知道
我说过老闭嘴	我说过了闭嘴
把嘴巴闭到	把嘴闭上
我看到老五个男人	我看到了五个男人
我应该切做	我应该去做
我学韩语	我学韩语
我以前是医生	我以前是医生
我在学习	我在学习
我要控告你	我要控告你
我想要切	我想要去
我会警告汤姆	我会警告汤姆
我会回来的	我会回来的
我会责备他	我会责备他
我会留意的	我会留意的
由我来做	由我来做
我会待在家里	我会待在家里
我请你	我请你
我是一个自由的人	我是一个自由的人
我是一个好人	我是一个好人
我是无神论者	我是无神论者
我在他后面	我在他后面
我今天有空	我今天有空
我不贪婪	我不贪婪
我莫得罪	我没有罪
我很激动	我很激动
我脱衣服	我脱衣服
我很快乐	我很快乐
我很幸福	我很幸福
我见过	我见过
他是日本人吗	他是日本人吗
那更好吗	那更好吗
它不是黑色的吗	它不是黑色的吗
太早老	太早了
太晚老	太晚了
那样说得通	那样说得通
它花老几个月	它花了几个月
这是全新的	这是全新的
它是危险的	它是危险的
这不好笑	这不好笑
它是我们的错误	它是我们的错误
这是事实	这是事实
这就要看您老	这就要看您了
由你来决定	由你来决定
非常冷	非常冷
做得很好	做得很好
它是你的书	它是你的书
该你走老	该你走了
继续听	继续听
让我切做	让我去做
让我们回家吧	让我们回家吧
我们吃吧	我们吃吧
听听这个	听听这个
我可以用吗	我可以用吗
我叫Tom	我叫Tom
现在我想起来老	现在我想起来了
请进来	请进来
麻烦您那样做	麻烦您那样做
请帮助我	请帮助我
请帮我	请帮我
请加入我们	请加入我们
请告诉我	请告诉我
请清洗它	请清洗它
物价上涨	物价上涨
看这本书	看这本书
说清楚	说清楚
科学好玩	科学好玩
她愚弄老他	她愚弄了他
她种老玫瑰	她种了玫瑰
她也许会来	她也许会来
她看来有钱	她看来有钱
烟雾出现老	烟雾出现了
有人打电话来	有人打电话来
停止发牢骚吧	停止发牢骚吧
停止抵抗	停止抵抗
夏天过切老	夏天过去了
你可以慢慢来	你可以慢慢来
慢慢来	慢慢来
那是一个耻辱	那是一个耻辱
那符合逻辑	那符合逻辑
那是我的大衣	那是我的大衣
那是完美的	那是完美的
那太糟糕老	那太糟糕了
旗子升起老	旗子升起了
电话正在响	电话正在响
他们目光相接	他们目光相接
这些是笔	这些是笔
他们恨汤姆	他们恨汤姆
他们有工作	他们有工作
他们让我走	他们让我走
他们喜欢那个	他们喜欢那个
他们信任汤姆	他们信任汤姆
他们想要更多	他们想要更多
他们想要这个	他们想要这个
他们不错	他们不错
这是一本书	这是一本书
那是我的包	那是我的包
汤姆能改变	汤姆能改变
汤姆不会游泳	汤姆不会游泳
汤姆有个计划	汤姆有个计划
汤姆不哈	汤姆不傻
汤姆看起来很苍白	汤姆看起来很苍白
汤姆喜欢狗	汤姆喜欢狗
汤姆走老出切	汤姆走了出去
汤姆无所畏惧	汤姆无所畏惧
汤姆在笑	汤姆在笑
汤姆兴奋不已	汤姆兴奋不已
开电视	开电视
汤姆睡着老吗	汤姆睡着了吗
洗您的脚	洗您的脚
洗你的脚	洗你的脚
自己当心啊	自己当心啊
我们原谅你	我们原谅你
我们哪个也不认识	我们谁也不认识
我们学习音乐	我们学习音乐
我们要继续下切	我们要继续下去
我们是个家庭	我们是个家庭
我们没迟到	我们没迟到
好嘛我们走嘛	好吧我们走吧
你是对的吗	你是对的吗
你的职业是啥子	你的职业是什么
她做啥子工作	她做什么工作
我们切哪儿	我们去哪儿
之前你在哪里	之前你在哪里
那家伙是哪个	那家伙是谁
那男人是哪个	那男人是谁
你问这个干啥子	你问这个干什么
为啥子他在这儿	为什么他在这儿
擦擦你的眼睛	擦擦你的眼睛
是的我晓得	是的我知道
是的当然	是的当然
你看起来很无聊	你看起来很无聊
你看起来很紧张	你看起来很紧张
你看起来很疲倦	你看起来很疲倦
你必须切做	你必须去做
你会爱它	你会爱它
你开玩笑吧	你开玩笑吧
您不必感谢我	您不必感谢我
你们是朋友吗	你们是朋友吗
你在开玩笑吗	你在开玩笑吗
你有18岁老吗	你有18岁了吗
你是认真的吗	你是认真的吗
你渴吗	你渴吗
球是圆的	球是圆的
为我感到高兴吧	为我感到高兴吧
规矩点	规矩点
黑色很衬你	黑色很衬你
烧一点水	烧一点水
叫警察	叫警察
报警	报警
你能找到它吗	你能找到它吗
你能帮我吗	你能帮我吗
您能帮我吗	您能帮我吗
清扫你的房间	清扫你的房间
打扫一哈你的房间	打扫一下你的房间
闭上你的眼睛	闭上你的眼睛
闭上你们的眼睛	闭上你们的眼睛
如果你能就来吧	如果你能就来吧
祝贺你	祝贺你
恭喜	恭喜
你能做到吗	你能做到吗
数到三十	数到三十
汤姆说是哪个老吗	汤姆说是谁了吗
你以前喜欢吗	你以前喜欢吗
你想我老	你想我了
您经常切吗	您经常去吗
你有吗	你有吗
你认识他吗	你认识他吗
你喜欢说唱音乐吗	你喜欢说唱音乐吗
你记得吗	你记得吗
爱存在吗	爱存在吗
莫被骗老	别被骗了
莫忘老我	别忘了我
莫忘老我们	别忘了我们
莫打开那个	别打开那个
不要冒险	不要冒险
莫说谎	别说谎
你不同意吗	你不同意吗
您不同意吗	您不同意吗
开车小心点	开车小心点
离开这里	离开这里
帮汤姆一把	帮汤姆一把
把它给他们	把它给他们
切露台	去露台
绿色适合你	绿色适合你
祝你一天过得愉快	祝你一天过得愉快
他行动迅速	他行动迅速
他开始哭老	他开始哭了
他是教师	他是教师
他是老师	他是老师
他是我父亲	他是我父亲
他非常亲切	他非常亲切
他很高	他很高
他刚到	他刚到
他喜欢迪士尼	他喜欢迪士尼
他看起来很强壮	他看起来很强壮
他喜欢火车	他喜欢火车
他向我施压	他向我施压
他努力学习	他努力学习
他企图扯谎	他企图说谎
他很容易觉得累	他很容易觉得累
他很老	他很老
他会倖存	他会倖存
他是喜剧演员	他是喜剧演员
他是个好人	他是个好人
他不是英雄	他不是英雄
他非常生气	他非常生气
这是账单	这是账单
这是你的茶	这是你的茶
嗨你好吗	嗨你好吗
他的话就是命令	他的话就是命令
你感觉如何	你感觉如何
我啷个晓得	我怎么知道
多么有趣啊	多么有趣啊
大家好吗	大家好吗
你几岁	你几岁
你真粗鲁	你真粗鲁
可怜	可怜
这个苹果啷个样	这个苹果怎么样
我全身酸痛	我全身酸痛
我是一个好男孩	我是一个好男孩
我是从中国来的	我是从中国来的
我来自中国	我来自中国
我有麻烦老	我有麻烦了
我遇到困难老	我遇到困难了
我吃老这个苹果	我吃了这个苹果
我烤老曲奇	我烤了曲奇
我开始跑	我开始跑
我订老一个位子	我订了一个位子
我买老一本书	我买了一本书
我打电话给汤姆老	我打电话给汤姆了
我叫她起来	我叫她起来
我看不见你	我看不见你
我不能取消它	我不能取消它
我不要	我不要
我感觉轻松老	我感觉轻松了
我六点起床	我六点起床
我讨厌学习	我讨厌学习
我有兄弟	我有兄弟
我有十支笔	我有十支笔
我要赶紧老	我要赶紧了
我有两只猫	我有两只猫
我有两个儿子	我有两个儿子
我刚才吐老	我刚才吐了
我借给他一盘CD	我借给他一盘CD
我也喜欢汤姆	我也喜欢汤姆
我喜欢茄子	我喜欢茄子
我喜欢足球	我喜欢足球
我喜欢土豆	我喜欢土豆
我喜欢寒冷	我喜欢寒冷
我喜欢这只狗	我喜欢这只狗
我喜欢您的车	我喜欢您的车
我住在罗马	我住在罗马
我丢老我的钱	我丢了我的钱
我爱这台车	我爱这台车
我可能会说是	我可能会说是
我必须帮助她	我必须帮助她
我需要个朋友	我需要个朋友
我需要一名律师	我需要一名律师
我需要证据	我需要证据
我需要我的靴子	我需要我的靴子
我需要你在这里	我需要你在这里
我只想要一件东西	我只想要一件东西
我买老单	我买了单
我打网球老	我打网球了
我每天跑步	我每天跑步
我说瑞典语	我说瑞典语
我和汤姆说老话	我和汤姆说了话
我跟她谈老话	我跟她谈了话
我教中文	我教中文
我想没关系	我想没关系
我洗老澡	我洗了澡
我想要一把吉他	我想要一把吉他
我想要那个袋子	我想要那个袋子
我想开车	我想开车
我吃惊老	我吃惊了
我希望你切	我希望你去
我起得早	我起得早
我工作得太多老	我工作得太多了
我会带酒来	我会带酒来
我绝不会停	我绝不会停
我是个侦探	我是个侦探
我是一个外国人	我是一个外国人
我是个夜猫子	我是个夜猫子
我快好老	我快好了
我总是有事	我总是有事
我一直在这里	我一直在这里
我在做白日梦	我在做白日梦
我觉得精神很好	我觉得精神很好
我在变老	我在变老
我是左撇子	我是左撇子
我不嫉妒	我不嫉妒
我不是认真的	我不是认真的
我没时间老	我没时间了
我挺忙	我挺忙
我相当高	我相当高
我真的好忙	我真的好忙
我真的冷	我真的冷
我还饿倒的	我还饿着呢
我很饿	我很饿
我很寂寞	我很寂寞
我已经受够老	我已经受够了
我已经吃饱老	我已经吃饱了
他在呼吸吗	他在呼吸吗
全都在那里吗	全都在那里吗
还有多余的盐吗	还有多余的盐吗
她是日本人吗	她是日本人吗
这是一条河吗	这是一条河吗
那是我的吗	那是我的吗
下老很多的雪	下了很多的雪
它很远	它很远
天要变多云老	天要变多云了
这是个死胡同	这是个死胡同
那本书是一本新书	那本书是一本新书
今天天气很好	今天天气很好
这是一个惊喜	这是一个惊喜
快要六点老	快要六点了
已经是11点老	已经是11点了
这是不可能的	这是不可能的
午餐时间到老	午餐时间到了
你可以走老	你可以走了
在那里	在那里
该走老	该走了
是该离开的时候老	是该离开的时候了
耶稣爱你	耶稣爱你
保持微笑	保持微笑
不用找零钱老	不用找零钱了
很大不是吗	很大不是吗
柠檬是酸的	柠檬是酸的
让我一个人切	让我一个人去
让他们决定	让他们决定
让我们吃寿司吧	让我们吃寿司吧
我们别吵老	我们别吵了
我们掉头吧	我们掉头吧
看天上	看天上
瞧你身后	瞧你身后
把它弄小一点	把它弄小一点
我现在能走老吗	我现在能走了吗
我能试一哈吗	我能试一下吗
也许下一次吧	也许下一次吧
男人应该工作	男人应该工作
圣诞快乐	圣诞快乐
妈妈我肚子饿老	妈妈我肚子饿了
我爸爸走路	我爸爸走路
我家很大	我家很大
永远不要说永远	永远不要说永远
莫得人迟到	没有人迟到
不我没切	不我没去
把瓶子打开	把瓶子打开
把嘴张开	把嘴张开
请安静	请安静
请继续	请继续
请坐下	请坐下
戴上你的帽子	戴上你的帽子
对毒品说不	对毒品说不
吓人不是么	吓人不是么
我们7点左右碰头	我们7点左右碰头
今晚见	今晚见
她冷静下来	她冷静下来
她消失老	她消失了
她举止优雅	她举止优雅
她转移老视线	她转移了视线
她看起来很年轻	她看起来很年轻
她弄丢老一本书	她弄丢了一本书
她嫁给老他	她嫁给了他
她把他叫醒老	她把他叫醒了
她努力地工作	她努力地工作
她是我的姊妹	她是我的姊妹
春天到老	春天到了
这只狗很大	这只狗很大
感觉良好	感觉良好
这不公平	这不公平
那不好闻	那不好闻
那是不公平的	那是不公平的
那太简单老	那太简单了
那是很大的	那是很大的
他是个好孩子	他是个好孩子
叶子落老	叶子落了
灯亮着	灯亮着
不急	不急
莫得盐	没有盐
他们都做老	他们都做了
它们是瓜	它们是瓜
他们卖糖果	他们卖糖果
这本书是新的	这本书是新的
这是我的自行车	这是我的自行车
这是我的书	这是我的书
这是我的妻子	这是我的妻子
这是结束	这是结束
这个太大老	这个太大了
这是典型的	这是典型的
这不好	这不好
这不是爱	这不是爱
吃饭时间到老	吃饭时间到了
汤姆也开腔老	汤姆也说话了
汤姆啥子都没做	汤姆什么都没做
汤姆不见老	汤姆不见了
汤姆睡着老	汤姆睡着了
汤姆觉得饿老	汤姆觉得饿了
汤姆莫得时间	汤姆没有时间
汤姆拥抱老玛丽	汤姆拥抱了玛丽
汤姆是种族主义者	汤姆是种族主义者
汤姆在逃跑	汤姆在逃跑
汤姆在游泳	汤姆在游泳
汤姆莫得说谎	汤姆没有说谎
汤姆住在这里	汤姆住在这里
汤姆看来难缠	汤姆看来难缠
汤姆留在家里	汤姆留在家里
汤姆是个护士	汤姆是个护士
汤姆在家的	汤姆在家的
汤姆被欺负老	汤姆被欺负了
汤姆很受欢迎	汤姆挺受欢迎
汤姆在啜泣	汤姆在啜泣
汤姆浪费时间	汤姆浪费时间
汤姆戴假发	汤姆戴假发
汤姆出国老	汤姆出国了
关闭电视机	关闭电视机
走路小心	走路小心
小心脚下	小心脚下
我们逃不出切	我们逃不出去
我们没时间	我们没时间
我们想知道	我们想知道
我们是朋友	我们是朋友
我们是加拿大人	我们是加拿大人
我们失切他们老	我们失去他们了
太惊喜老	太惊喜了
汤姆能做啥子	汤姆能做什么
他说老啥子	他说了什么
我们要啥子	我们要什么
少老啥子	少了什么
几点老	几点了
现在几点	现在几点
爪子	怎么了
你啷个老	你怎么了
马尼拉在哪里	马尼拉在哪里
我父亲在哪里	我父亲在哪里
我的妻子在哪里	我的妻子在哪里
这个男孩哪个	这个男孩是谁
哪个喜欢豆子	谁喜欢豆子
哪个在耍	谁在玩
我们为啥子失败老	我们为甚么失败了
你为啥子哭	你为什么哭
为啥子现在做那个	为什么现在做那个
他为啥生气	他为啥生气
狼吓到老我	狼吓到了我
你可以进来	你可以进来
你能告诉我们	你能告诉我们
你看上切很哈	你看上去很傻
你必须选择	你必须选择
你最好走	你最好走
你会迷路的	你会迷路的
你是人	你是人
你真是太对老	你真是太对了
你很害羞	你很害羞
你们被骗老	你们被骗了
您被骗老	您被骗了
你的时间到老	你的时间到了
事故发生	事故发生
接电话	接电话
你是日本人吗	你是日本人吗
你是医生吗	你是医生吗
你是个术士吗	你是个术士吗
现在你们忙吗	现在你们忙吗
现在您忙吗	现在您忙吗
你结束老吗	你结束了吗
你们是学生吗	你们是学生吗
你们学习吗	你们学习吗
你不快乐吗	你不快乐吗
问他一哈他的名字	问他一下他的名字
我能休息一哈儿吗	我能休息一会儿吗
我能在这里睡觉吗	我能在这里睡觉吗
有人会开车吗	有人会开车吗
这个能吃吗	这个能吃吗
你能救汤姆吗	你能救汤姆吗
闭上你的嘴巴	闭上你的嘴
现在就跟我来	现在就跟我来
你试过吗	你试过吗
你见过汤姆老吗	你见过汤姆了吗
你可以随心所欲	你可以随心所欲
你有电视吗	你有电视吗
你们有小娃儿吗	你们有小孩吗
你喜欢雪吗	你喜欢雪吗
你住这里吗	你住这里吗
你需要帮助吗	你需要帮助吗
你拥有枪支吗	你拥有枪支吗
你相信她吗	你相信她吗
你想要更多吗	你想要更多吗
你们要米饭吗	你们要米饭吗
莫开玩笑老	别开玩笑了
喝这果汁	喝这果汁
每个人都在笑	每个人都在笑
每个人都看见老	每个人都看见了
所有人都注意到老	所有人都注意到了
像男人一样战斗	像男人一样战斗
为老啥子目的	为了什么目的
上马	上马
给汤姆一把椅子	给汤姆一把椅子
给我这本书	给我这本书
把书给我	把书给我
直接回家	直接回家
上楼	上楼
他触犯老法律	他触犯了法律
他能读得很好	他能读得很好
他着凉老	他着凉了
他感冒老	他感冒了
他最近去世老	他最近去世了
他有长头发	他有长头发
他听到老叫声	他听到了叫声
他是意大利人	他是意大利人
他有麻烦	他有麻烦
他不是哈儿	他不是傻子
他还在这儿	他还在这儿
他刚回到家	他刚回到家
他喜欢钓鱼	他喜欢钓鱼
他喜欢打猎	他喜欢打猎
他喜欢橙子	他喜欢橙子
他酷爱钓鱼	他酷爱钓鱼
他一定很爱你	他一定很爱你
他画老一只狗	他画了一只狗
他打老网球	他打了网球
他关上了门	他关上了门
他戴眼镜	他戴眼镜
他破产老	他破产了
他写阿拉伯文	他写阿拉伯文
他在她的旁边	他在她的旁边
他刚来这镇上	他刚来这镇上
他是你的朋友	他是你的朋友
你的袋子在这里	你的袋子在这里
你好吗汤姆	你好吗汤姆
汤姆啷个晓得	汤姆怎么知道
我啷个报名参加呢	我怎样报名参加呢
你太太啷个样	你太太怎么样
这有多长	这有多长
这是好多	这是多少
你好高	你多高
食物啷个样	食物怎么样
我同意他	我同意他
我差点被淹死	我差点被淹死
我总是在外面吃饭	我总是在外面吃饭
我有点醉老	我有点醉了
我在吃米饭	我在吃米饭
我不是巫婆	我不是巫婆
我不好奇	我不好奇
我是你老子	我是你爸爸
我打赌汤姆忘老	我打赌汤姆忘了
我买老一只手表	我买了一只手表
我听不到你的声音	我听不到你的声音
遇不到你	遇不到你
我记不得老	我记不得了
我想不起来	我想不起来
我不能忍受	我不能忍受
我收集邮票	我收集邮票
我能看见	我能看见
我无法入睡	我无法入睡
我睡不昨	我睡不着
你睡得昨吗	你睡得着吗
我没有喜欢过你	我没有喜欢过你
我不是这个意思	我不是这个意思
我没见到他	我没见到他
我原谅汤姆	我原谅汤姆
我莫得疑问	我没有疑问
我不认识她	我不认识她
我不喜欢她	我不喜欢她
我不喜欢喝茶	我不喜欢喝茶
我不喜欢你	我不喜欢你
我不记得老	我不记得了
我不想要你	我不想要你
我过老难挨的一天	我过了难挨的一天
我讨厌化学	我讨厌化学
我有条大狗	我有条大狗
我有辆新车	我有辆新车
我问过他	我问过他
我莫得借口	我没有借口
我必须拒绝	我必须拒绝
我希望汤姆输	我希望汤姆输
我知道它有困难	我知道它有困难
我知道真相	我知道真相
我喜欢巧克力	我喜欢巧克力
我喜欢流行音乐	我喜欢流行音乐
我喜欢红色的玫瑰	我喜欢红色的玫瑰
我喜欢旅行	我喜欢旅行
我喜欢你们的城市	我喜欢你们的城市
我喜欢你的房间	我喜欢你的房间
我住在这附近	我住在这附近
我爱这首歌	我爱这首歌
我犯老一个错	我犯了一个错
我让她生气	我让她生气
我自己做的	我自己做的
我非常想你	我非常想你
我需要更多时间	我需要更多时间
我仍然爱着她	我仍然爱着她
我依旧爱着他	我依旧爱着他
我试倒微笑	我试着微笑
我也要牛肉	我也要牛肉
我要多很多	我要多很多
我要你切	我要你去
我要你的爱	我要你的爱
我没有在吼	我没有在吼
我写老一封信	我写了一封信
我不会做任何事	我不会做任何事
我今晚有空	我今晚有空
我只是随便看哈	我只是随便看看
我不是乞丐	我不是乞丐
我不是医生	我不是医生
我现在不忙	我现在不忙
我没那么勇敢	我没那么勇敢
我不是老板	我不是老板
我站在你这边	我站在你这边
我以你为荣	我以你为荣
我累死老	我累死了
我在家里待倒	我在家里待着
我还很困	我还很困
我很渴	我很渴
我弄丢老我的笔	我弄丢了我的笔
她是正确的吗	她是正确的吗
那是你的车吗	那是你的车吗
门开着吗	门开着吗
工作困难吗	工作困难吗
这是你的车吗	这是你的车吗
这是你的笔吗	这是你的笔吗
他不是意大利人吗	他不是意大利人吗
开始下雪老	开始下雪了
那不可能是真的	那不可能是真的
这是个好主意	这是个好主意
那是一朵向日葵	那是一朵向日葵
真的很冰冷	真的很冰冷
难讲喔	难讲喔
只是感冒噻	只是感冒而已
这没啥子大不了的	这没什么大不了的
这不是手表	这不是手表
它在沙发上	它在沙发上
还早噻	还早呢
吃晚饭的时间到老	吃晚饭的时间到了
它很正常	它很正常
这很简单	这很简单
日本在亚洲	日本在亚洲
别让狗进来	别让狗进来
来商量嘛	来商量吧
让我们放风筝	让我们放风筝
我们进屋噻	我们进屋吧
让我们搭公车噻	让我们搭公车吧
我们告哈	我们试试
仔细听倒	仔细听着
听我说好吗	听我说好吗
把这封信寄老	把这封信寄了
做出您的选择	做出您的选择
火星是一颗行星	火星是一颗行星
我的相簿在这里	我的相簿在这里
我家在这里	我家在这里
我胃痛	我胃痛
很高兴认识你	很高兴认识你
没人会讲	没人会讲
没人知道为啥子	没人知道为什么
莫得人喜欢战争	没有人喜欢战争
啥子事都没有发生	什么事都没有发生
请给我盐	请给我盐
麻烦拷贝这个	麻烦拷贝这个
请不要问	请不要问
请让我走	请让我走
把箱子放下	把箱子放下
她开始哭泣	她开始哭泣
她看不起他	她看不起他
她不喜欢他	她不喜欢他
她是女教师	她是女教师
她跟我生气老	她跟我生气了
她不停地工作	她不停地工作
她穿上袜子	她穿上袜子
她停下来抽烟	她停下来抽烟
她晋升老	她晋升了
有人扯把子	有人说谎
对不起我来晚老	对不起我来晚了
夏天已经结束	夏天已经结束
游泳很容易	游泳很容易
跟我讲讲那件事	跟我讲讲那件事
那是一支铅笔	那是一支铅笔
那是有道理的	那是有道理的
那不好	那不好
那是可避免的	那是可避免的
那是我们的房子	那是我们的房子
这正是问题的关键	这正是问题的关键
那太稀少老	那太稀少了
盒子里面莫得东西	盒子里面没有东西
汽车准备好老	汽车准备好了
谢幕老	谢幕了
这只狗快要死老	这只狗快要死了
火熄灭老	火熄灭了
那人没穿衣服	那人没穿衣服
天空很晴朗	天空很晴朗
风暴减弱老	风暴减弱了
这口井干刮老	这口井干涸了
这块田干刮了	这块田干涸了
有风险	有风险
毫无疑问	毫无疑问
莫得糖	没有糖
莫得水	没有水
他们没死	他们没死
他们喜欢苹果	他们喜欢苹果
他们害怕老	他们害怕了
他们要杀你	他们要杀你
他们是小娃儿	他们是小孩子
她们是小娃儿	她们是小孩子
这个男娃儿很懒	这个男孩子很懒
这是839号房间	这是839号房间
这是一支铅笔	这是一支铅笔
这个不行	这个不行
这不安全	这不安全
这是最好的	这是最好的
这是你的狗	这是你的狗
这是您的钥匙	这是您的钥匙
这不是钱	这不是钱
这个是你的	这个是你的
今天三号	今天三号
汤姆买老辆车	汤姆买了辆车
汤姆不能开车	汤姆不能开车
汤姆又做老一次	汤姆又做了一次
Tom莫得钱	Tom没有钱
汤姆弄伤老自己	汤姆弄伤了自己
汤姆是个胖子	汤姆是个胖子
汤姆是个学生	汤姆是个学生
汤姆是艺术家	汤姆是艺术家
汤姆是个骗子	汤姆是个骗子
汤姆有危险	汤姆有危险
汤姆是我的朋友	汤姆是我的朋友
汤姆人很好	汤姆人很好
汤姆不是哈儿	汤姆不是傻瓜
汤姆不是英雄	汤姆不是英雄
汤姆喜欢热的	汤姆喜欢热的
汤姆丢老工作	汤姆丢了工作
汤姆看老文件	汤姆看了文件
汤姆努力学习	汤姆努力学习
汤姆走得很慢	汤姆走得很慢
汤姆会做	汤姆会做
汤姆会接受	汤姆会接受
把煤气关老	把煤气关了
我们接受支票	我们接受支票
我们可全指望你老	我们可全指望你了
我们可全靠你老	我们可全靠你了
我们打算赢	我们打算赢
我们有两只耳朵	我们有两只耳朵
我们帮助穷人	我们帮助穷人
我们才刚搬进来	我们才刚搬进来
我们住在一起	我们住在一起
我们比赛输老	我们比赛输了
我们可能需要一些	我们可能需要一些
我们需要汤姆回来	我们需要汤姆回来
我们必须走老	我们必须走了
我们从不放弃	我们从不放弃
我们谈谈比较好	我们谈谈比较好
后会有期	后会有期
我们会保持安静	我们会保持安静
我们过一哈再谈	我们过一会再谈
我们都饿老	我们都饿了
我们是同学	我们是同学
我们在高兴地玩	我们在高兴地玩
我们很匆忙	我们很匆忙
我们很急	我们很急
我们不傻	我们不傻
欢迎到日本	欢迎到日本
多好的主意啊	多好的主意啊
她说老啥子	她说了什么
你买老啥子	你买了什么
您有啥子	您有什么
你知道啥子	你知道什么
你做啥子	你做什么
你想要啥子	你想要什么
它是关于啥子	它是关于什么
我该做啥子	我该做什么
啥子吵醒你老	什么吵醒你了
他在藏啥子	他在藏甚么
她在做啥子	她在做什么
你叫啥子名字	你叫什么名字
您叫啥子名字	您叫什么名字
叫啥子名字	叫什么名字
我的书在哪	我的书在哪
我的位子在哪儿	我的位子在哪儿
老板在哪里	老板在哪里
你的狗在哪里	你的狗在哪里
哪个决定老那件事	谁决定了那件事
哪个找到老我的包	谁找到了我的包
哈姆雷特是哪个写的	哈姆雷特是谁写的
轮到哪个老	轮到谁了
你为啥子在这	你为什么在这
你为啥子辞职	你为什么辞职
他为啥子在躲藏	他为什么在躲藏
你会参加吗	你会参加吗
冬季快来老	冬季快来了
你脸红老	你脸红了
你无法说“不”	你无法说“不”
你得行动老	你得行动了
你有必要了解	你有必要了解
你不应该切	你不应该去
你缺乏耐心	你缺乏耐心
你挡倒老我的路	你挡住了我的路
你不是歌手	你不是歌手
我反应过度老吗	我反应过度了吗
他们是学生吗	他们是学生吗
你们都准备好老吗	你们都准备好了吗
你现在高兴吗	你现在高兴吗
你闻吗	你闻吗
对他人要友善	对他人要友善
小心狗	小心狗
注意小偷	注意小偷
鸟儿筑巢	鸟儿筑巢
叫救护车	叫救护车
我可以吃一口吗	我可以吃一口吗
我能试一哈吗	我能试一下吗
我们能信任他们吗	我们能信任他们吗
你能冷冻它吗	你能冷冻它吗
你能跳绳吗	你能跳绳吗
给我香槟谢谢	给我香槟谢谢
从中选择一人	从中选择一人
圣诞节快到老	圣诞节快到了
收拾房间	收拾房间
快来这里	快来这里
来嘛快一点	来吧快一点
来嘛我们一起切	来吧我们一起去
来嘛摸一哈	来吧摸一下
来嘛相信我	来吧相信我
您会告诉我吗	您会告诉我吗
发牌给我们	发牌给我们
你借它老吗	你借它了吗
你有买果汁吗	你有买果汁吗
我需要做手术吗	我需要做手术吗
你相信我吗	你相信我吗
你喝啤酒吗	你喝啤酒吗
你觉得幸运吗	你觉得幸运吗
你觉得累吗	你觉得累吗
你有车吗	你有车吗
您有车吗	您有车吗
你有地图吗	你有地图吗
你喜欢中国吗	你喜欢中国吗
你喜欢果汁吗	你喜欢果汁吗
你喜欢音乐吗	你喜欢音乐吗
你爱音乐吗	你爱音乐吗
你明白老吗	你明白了吗
别让汤姆死老	别让汤姆死了
别让我失望	别让我失望
不要拉我的腿	不要拉我的腿
别对倒我吼	别对着我吼
莫碰这些	不要碰这些
地球是一个行星	地球是一个行星
每个人都好	每个人都好
大家笑老	大家笑了
大家都认识我	大家都认识我
大家都还行	大家都还行
一切都很糟糕	一切都很糟糕
欢迎留下来	欢迎留下来
进你的车里	进你的车里
把这本书给她	把这本书给她
上帝保佑美国	上帝保佑美国
神无处不在	神无处不在
钟响过老吗	钟响过了吗
欲速则不达	欲速则不达
他开始喊叫	他开始喊叫
他亲自来老	他亲自来了
他来看我老	他来看我了
他不能帮你	他不能帮你
他不能游泳	他不能游泳
他昨天切世老	他昨天去世了
他没听	他没听
他有些钢笔	他有些钢笔
他有七个儿子	他有七个儿子
他有三个儿子	他有三个儿子
是他自己做的	是他自己做的
他是一个怪人	他是一个怪人
他不过是个孩子	他不过是个孩子
他在看电视	他在看电视
他喜欢睡觉	他喜欢睡觉
他给我做老套衣服	他给我做了套衣服
他划老一根火柴	他划了一根火柴
他出国留学老	他出国留学了
他把球扔老	他把球扔了
他说老实话	他说了实话
他转动钥匙	他转动钥匙
他会回来的	他会回来的
他赢得一切老	他赢得一切了
他写老一封信	他写了一封信
他有点活泼	他有点活泼
他还没到这里	他还没到这里
这是你的书	这是你的书
这是找零	这是找零
它有多复杂	它有多复杂
我啷个晓得	我怎么知道
你的测验啷个样	你的测验怎么样
你的旅行啷个样	你的旅行怎么样
我同意她	我同意她
我是素食主义者	我是素食主义者
我喜欢车	我喜欢车
我来自四国	我来自四国
我在家里	我在家里
我在右边	我在右边
我现在正在学习	我现在正在学习
我每天都洗澡	我每天都洗澡
我相信爱情	我相信爱情
我买老那辆车	我买了那辆车
我可以安慰她	我可以安慰她
我可以独自做	我可以独自做
我会开车	我会开车
我几乎不能走路	我几乎不能走路
我会弹萧邦	我会弹萧邦
我会抓足球	我会踢足球
我会打网球	我会打网球
我受不老他	我受不了他
我没觉得不好	我没觉得不好
我不接受	我不接受
我不怪你	我不怪你
我感觉不舒服	我感觉不舒服
我不喜欢吃鸡蛋	我不喜欢吃鸡蛋
我不喜欢鸡蛋	我不喜欢鸡蛋
我不喜欢小孩	我不喜欢小孩
我不喜欢	我不喜欢
我不喜欢红酒	我不喜欢红酒
我不后悔	我不后悔
我给老你一本书	我给了你一本书
我被蜜蜂蛰老一哈	我被蜜蜂蛰了一下
我把我的头发剪老	我把我的头发剪了
我7点起床老	我7点起床了
我做噩梦老	我做噩梦了
我恨蚊子	我恨蚊子
我有一台电脑	我有一台电脑
我有一个女儿	我有一个女儿
我头痛	我头痛
我有个提案	我有个提案
我有一个意见	我有一个意见
我有许多唱片	我有许多唱片
我莫得朋友	我没有朋友
我没改变	我没改变
我没有遇见她	我没有遇见她
我希望能见到你	我希望能见到你
我喜欢短发	我喜欢短发
我很喜欢雪	我很喜欢雪
我喜欢你的房子	我喜欢你的房子
我喜欢你的鞋子	我喜欢你的鞋子
我的行李丢老	我的行李丢了
我需要很多书	我需要很多书
我需要更多的钱	我需要更多的钱
我坐在他旁边	我坐在他旁边
我看见老他跑步	我看见了他跑步
我看老日出	我看了日出
我该高兴	我该高兴
我在学校读书	我在学校读书
我认我会留下	我认我会留下
我想我是对的	我想我是对的
我试图逃跑	我试图逃跑
我通常在外面吃饭	我通常在外面吃饭
我想让汤姆赢	我想让汤姆赢
我要回家	我要回家
我很想家	我很想家
我继续阅读	我继续阅读
我会尽力而为	我会尽力而为
我希望我可以切	我希望我可以去
我在两点半起床	我在两点半起床
我中奖老	我中奖了
我为一家银行工作	我为一家银行工作
我工作数小时	我工作数小时
我担心他	我担心他
我自己写老它	我自己写了它
我写老这本书	我写了这本书
我想要跳舞	我想要跳舞
我要戴头盔	我要戴头盔
我会晚一点回来	我会晚一点回来
我会自己走	我会自己走
我来付账	我来付账
我会告诉我的妻子	我会告诉我的妻子
我是个新生	我是个新生
我能说	我能说
我不擅长运动	我不擅长运动
我很有耐心	我很有耐心
我要输老	我要输了
我不是学生	我不是学生
我不太聪明	我不太聪明
我站在汤姆一边	我站在汤姆一边
我还不明白	我还不明白
汤姆是好人	汤姆是好人
那是纯金吗	那是纯金吗
浴室干净吗	浴室干净吗
聚会结束老吗	聚会结束了吗
这是你的书吗	这是你的书吗
今天有风	今天有风
它是我们的秘密	它是我们的秘密
这是一个好的开端	这是一个好的开端
都是我的错	都是我的错
已经是早上七点老	已经是早上七点了
这是机密	这是机密
这里够热	这里够热
它是人的天性	它是人的天性
它是我兄弟的	它是我兄弟的
不是我的错	不是我的错
不是那么远	不是那么远
这是免费的	这是免费的
这是我们的荣幸	这是我们的荣幸
它真重	它真重
这是不证自明的	这是不证自明的
到谈话的时间老	到谈话的时间了
它很特别	它很特别
这里是温暖的	这里是温暖的
靠右侧通行	靠右侧通行
让我们开始嘛	让我们开始吧
干活吧噻	干活吧
切踢足球噻	去踢足球吧
让我们握手噻	让我们握手吧
让我们看看噻	让我们看看吧
我们休息一哈噻	我们休息一下吧
生活是美丽的	生活是美丽的
人生良苦	人生良苦
好久不见	好久不见
真是好久不见啊	真是好久不见啊
看着我的眼睛	看着我的眼睛
我爸爸很忙	我爸爸很忙
我肩膀痛	我肩膀痛
我的胃是胀满的	我的胃是胀满的
我吃得很饱	我吃得很饱
啥子问题都莫得	什么问题都没有
一点问题都莫得	一点问题都没有
莫得任何问题	没有任何问题
接一哈电话	接一下电话
请联系我们	请联系我们
请原谅我	请原谅我
请重新考虑一哈	请重新考虑一下
请包起来	请包起来
假装你是我	假装你是我
熄灯	熄灯
把爪爪举起来	把手举起来
用英语说	用英语说
替你们脸红啊	替你们脸红啊
她开始唱歌老	她开始唱歌了
她大声诅咒	她大声诅咒
她没有走远	她没有走远
她有蓝色的眼睛	她有蓝色的眼睛
她喜欢柳橙	她喜欢柳橙
她喜欢橙子	她喜欢橙子
她看起来不快落	她看起来不快乐
快落风男	快乐风男
非常快落	非常快乐
好快落	好快乐
她卖花	她卖花
她上楼老	她上楼了
她痛哭	她痛哭
她在浴室	她在浴室
她是我女儿	她是我女儿
她不是小娃儿	她不是小孩
我该帮你吗	我该帮你吗
莫烦我	不要烦我
告诉我真相	告诉我真相
那栋房子很大	那栋房子很大
那是可燃的	那是可燃的
那是你的书	那是你的书
那真是极好的	那真是极好的
那不好笑	那不好笑
那是一只野鸡	那是一只野鸡
这是我的问题	这是我的问题
这很方便	这很方便
浴缸已经准备好老	浴缸已经准备好了
这只猫在吃东西	这只猫在吃东西
钟停老	钟停了
这只狗跑走老	这只狗跑走了
门铃儿响老	门铃儿响了
市场很大	市场很大
会议结束老	会议结束了
疼痛消失老	疼痛消失了
汤很稠	汤很稠
系统运行起来老	系统运行起来了
货车走老	货车走了
最坏的已经过切老	最坏的已经过去了
有罢工	有罢工
他们在吃午饭	他们在吃午饭
他们非常大	他们非常大
他们看不见我	他们看不见我
他们都喜欢唱歌	他们都喜欢唱歌
他们担心	他们担心
他们有危险	他们有危险
这个苹果是坏的	这个苹果是坏的
这本书就行老	这本书就行了
这可能很好玩	这可能很好玩
这张书桌是我的	这张书桌是我的
这是他的车	这是他的车
这是一个奇迹	这是一个奇迹
很美味	很美味
这很难	这很难
这很贵	这很贵
这是胡说	这是胡说
这是我母亲	这是我母亲
这太无聊老	这太无聊了
这让我难过	这让我难过
今天是礼拜四	今天是礼拜四
汤姆成老英雄	汤姆成了英雄
汤姆开始说话	汤姆开始说话
汤姆最近死老	汤姆最近死了
汤姆给老我一枝笔	汤姆给了我一枝笔
汤姆有很多猫	汤姆有很多猫
汤姆恨蜘蛛	汤姆恨蜘蛛
汤姆啥子也没听到	汤姆什么也没听见
汤姆帮老我们	汤姆帮了我们
汤姆是魔法师	汤姆是魔法师
汤姆是个真男人	汤姆是个真男人
汤姆在这里很高兴	汤姆在这里很高兴
汤姆超重老	汤姆超重了
汤姆很安静	汤姆很安静
汤姆不是不高兴	汤姆不是不高兴
汤姆喜欢编织	汤姆喜欢编织
汤姆住在我的附近	汤姆住在我的附近
汤姆热爱花卉	汤姆热爱花卉
汤姆爱唱歌	汤姆爱唱歌
汤姆做出老选择	汤姆做出了选择
汤姆想念波士顿老	汤姆想念波士顿了
汤姆抢老家银行	汤姆抢了家银行
汤姆送我切老那里	汤姆送我去了那里
汤姆闭上老眼睛	汤姆闭上了眼睛
汤姆要爆米花	汤姆要爆米花
汤姆想说话	汤姆想说话
汤姆很虚弱	汤姆很虚弱
汤姆不在床上	汤姆不在床上
汤姆在家工作	汤姆在家工作
请回来	请回来
打开收音机	打开收音机
请来两杯啤酒	请来两杯啤酒
使用它或失去它	使用它或失去它
汤姆吃惊吗	汤姆吃惊吗
那太多老吗	那太多了吗
水是液体	水是液体
我们啥子都做不老	我们什么都做不了
我们不这样认为	我们不这样认为
我们莫得秘密	我们没有秘密
我们希望汤姆没事	我们希望汤姆没事
我们必须介入	我们必须介入
我们需要更多食物	我们需要更多食物
我们需要你的帮忙	我们需要你的帮忙
我们六点开始	我们六点开始
我们那时是孩子	我们那时是孩子
我们战争胜利老	我们战争胜利了
我们没有看着	我们没有看着
我们是老朋友老	我们是老朋友了
他们是认真的吗	他们是认真的吗
您听到啥子老	您听到什么了
你做老啥子	你做了什么
你认为如何	你认为如何
这是啥子意思	这是什么意思
汤姆在说啥子	汤姆在说甚么
我们晚饭吃啥子	我们晚饭吃什么
啷个老	怎么了
你的爱好是啥子	你的爱好是什么
你们公司几点下班	你们公司几点下班
你现在在哪里呢	你现在在哪里呢
我的手表在哪里	我的手表在哪里
银行在哪里	银行在哪里
那本书在哪儿	那本书在哪儿
哪里痛	哪里痛
你的狗在哪儿	你的狗在哪儿
伏特加在哪里	伏特加在哪里
哪颗牙痛	哪颗牙痛
那是哪个发明的	那是谁发明的
这辆汽车是哪个的	这辆汽车是谁的
这台汽车是哪个的	这台汽车是谁的
这是哪个的车	这是谁的车
是哪个的错呢	是谁的错呢
这是哪个的主意	这是谁的主意
你为啥子一个人	你为什么一个人
你为啥子生气	你为什么生气
你为啥子醒着	你为什么醒着
你为啥子迟到	你为什么迟到
她为啥子要说谎	她为甚么要说谎
你会在那里吗	你会在那里吗
你愿意嫁给我吗	你愿意嫁给我吗
你要用这个吗	你要用这个吗
是的没错	是的没错
你是学生	你是学生
您是学生	您是学生
你真傻	你真傻
你来得很快	你来得很快
你没发烧	你没发烧
您要赶快些	您要赶快些
你们得走老	你们得走了
你得走老	你得走了
你知道得太多老	你知道得太多了
我被你逗乐老	我被你逗乐了
你让我快乐	你让我快乐
您可以拿倒这个	您可以拿着这个
你必须离开	你必须离开
你说太多老	你说太多了
你不会需要它	你不会需要它
你工作太努力老	你工作太努力了
你真是警惕	你真是警惕
你很聪明	你很聪明
你做老很多	你做了很多
任何人都可以做到	任何人都可以做到
你今天忙吗	你今天忙吗
你还冷吗	你还冷吗
你睁着眼吗	你睁着眼吗
你不渴吗	你不渴吗
当心它	当心它
早饭准备好老	早饭准备好了
我能看那个吗	我能看那个吗
我能看看这个吗	我能看看这个吗
我可以用你的笔吗	我可以用你的笔吗
我们现在能回去吗	我们现在能回去吗
可以原谅我吗	可以原谅我吗
跟我们一起来噻	跟我们一起来吧
进来门开着	进来门开着
来再试试看	来再试试看
你把它们带来老么	你把它们带来了么
你检查这个老吗	你检查这个了吗
你喜欢苹果吗	你喜欢苹果吗
你喜欢坐飞机吗	你喜欢坐飞机吗
你们喜欢学校吗	你们喜欢学校吗
您喜欢学校吗	您喜欢学校吗
你抓足球吗	你踢足球吗
你的牙龈流血吗	你的牙龈流血吗
很痛吗	很痛吗
别被吓坏老	别被吓坏了
不要错过公车	不要错过公车
不要放弃英语	不要放弃英语
别胡说	别胡说
你不这么认为吗	你不这么认为吗
每个人都做老那事	每个人都做了那事
所有人都是活着的	所有人都是活着的
人固有一死	人固有一死
大家都喜欢汤姆	大家都喜欢汤姆
所有人都喝醉老	所有人都喝醉了
每个人都高兴	每个人都高兴
任何事情都是重要	任何事情都是重要
内用还是外带	内用还是外带
把那个号码给我	把那个号码给我
给我报告	给我报告
给我你的手机	给我你的手机
戴上你的安全帽	戴上你的安全帽
你们吃饭老吗	你们吃饭了吗
他及时赶到	他及时赶到
他准时来老	他准时来了
他问候老你	他问候了你
他会开车	他会开车
他真的说得很好	他真的说得很好
他给老他一本书	他给了他一本书
他下老公车	他下了公车
他还没来	他还没来
他给自己投老保险	他给自己投了保险
他是个糟糕的司机	他是个糟糕的司机
他上电台老	他上电台了
他是这么的无情	他是这么的无情
他杀死老那个人	他杀死了那个人
他在我面前撒谎	他在我面前撒谎
他爱旅行	他爱旅行
他从来没说过那个	他从来没说过那个
他玩得很好	他玩得很好
他弹得很好	他弹得很好
他举起他的手	他举起他的手
他六点回来老	他六点回来了
他好像病老	他好像病了
他开老先河	他开了先河
他说话太快老	他说话太快了
他仍然爱着她	他仍然爱着她
他偷老她的手表	他偷了她的手表
他休老一周的假	他休了一周的假
他要爱	他要爱
他独自在那里	他独自在那里
他骑自行车切的	他骑自行车去的
他骑脚踏车切	他骑脚踏车去
他会等你	他会等你
他有点苍白	他有点苍白
他是个吸毒男	他是个吸毒男
他已经是个男人老	他已经是个男人了
他在靠近	他在靠近
他心情不好	他心情不好
他是我新交的朋友	他是我新交的朋友
她的头发长回来老	她的头发长回来了
她的皮肤光滑	她的皮肤光滑
她的袜子是灰色的	她的袜子是灰色的
这是我的行李	这是我的行李
他啷个找到我们的	他怎么找到我们的
这是啷个运行的	这是怎么运行的
天气怎样	天气怎样
我接受老报价	我接受了报价
我完全同意	我完全同意
我几乎从不说谎	我几乎从不说谎
我是独生子	我是独生子
我来自四川	我来自四川
我不是个老师	我不是个老师
我六英尺高	我六英尺高
我吃老炸薯条	我吃了炸薯条
我每天洗一次澡	我每天洗一次澡
我烧老纸	我烧了纸
我啥子都能吃	我甚么都能吃
我可以等你	我可以等你
我莫法相信	我没法相信
我不可以喝牛奶	我不可以喝牛奶
我不能喝牛奶	我不能喝牛奶
我拍手	我拍手
我莫得那个意思	我没有那个意思
我不想要这个	我不想要这个
我莫得汽车	我没有汽车
我莫得猫	我没有猫
我莫得狗	我没有狗
我不喜欢寿司	我不喜欢寿司
我不吸大麻	我不吸大麻
不明白	不明白
我梦到你老	我梦到你了
我切哪里都开车	我去哪里都开车
我期待你的帮助	我期待你的帮助
我感觉很舒服	我感觉很舒服
我想休息一哈	我想休息一下
我给老玛丽一本书	我给了玛丽一本书
我玩得很开心	我玩得很开心
我要他写	我要他写
我得给汤姆打电话	我得给汤姆打电话
我得说这事	我得说这事
我听到他出切老	我听到他出去了
我知道她的地址	我知道她的地址
我知道那种感觉	我知道那种感觉
我知道问题	我知道问题
我认识那些女孩	我认识那些女孩
我认识那些女人	我认识那些女人
我知道他做老	我知道他做了
我知道要说啥子	我知道要说什么
我更喜欢洛杉矶	我更喜欢洛杉矶
我很喜欢烛光	我很喜欢烛光
我喜欢数学	我喜欢数学
我喜欢那个人	我喜欢那个人
我看老看周围	我看了看周围
我丢老我的伞	我丢了我的伞
我爱苹果汁	我爱苹果汁
我另有计划	我另有计划
我那么想念她	我那么想念她
我想念我的孩子	我想念我的孩子
我如此想念你	我如此想念你
好想见到你	好想见到你
我错过老我的机会	我错过了我的机会
我需要你的意见	我需要你的意见
我打算切那里	我打算去那里
我看见他逃跑老	我看见他逃跑了
我掴老他的脸	我掴了他的脸
我每周游一次泳	我每周游一次泳
我想他会来的吧	我想他会来的吧
我想他很快落	我想他很快乐
我八点起床	我八点起床
我走路到学校	我走路到学校
我要这台相机	我要这台相机
我想切那里	我想去那里
我要红色的鞋子	我要红色的鞋子
那个时候我在家	那个时候我在家
我生于1988年	我生于1988年
我一直在期待着	我一直在期待着
我也紧张	我也紧张
我很放松	我很放松
我会继续前进	我会继续前进
但愿我有一辆车	但愿我有一辆车
但愿我很有钱	但愿我很有钱
我想请你们帮个忙	我想请你们帮个忙
我会见到你	我会见到你
我会叫汤姆回来	我会叫汤姆回来
我会需要帮助	我会需要帮助
我要一直做下切	我要一直做下去
等哈儿见	等会儿见
我会考虑一哈	我会考虑一下
我有点累	我有点累
我怕狗	我怕狗
我跟你一样高	我跟你一样高
我是从新加坡来的	我是从新加坡来的
我很高兴它结束老	我很高兴它结束了
我正要切签到	我正要去签到
我擅长滑雪	我擅长滑雪
我擅长足球	我擅长足球
我擅长网球	我擅长网球
我失去老控制	我失去了控制
我在制作电影	我在制作电影
我不感兴趣	我不感兴趣
我有点不安逸	我有点不舒服
我准备好出发老	我准备好出发了
我很着急	我很着急
我太忙老不能切	我太忙了不能去
我增加老体重	我增加了体重
我现在得走老	我现在得走了
我已经变得好多老	我已经变得好多了
我把我的表丢老	我把我的表丢了
我从来没有见过他	我从来没有见过他
无知就是幸福	无知就是幸福
这么大的够用吗	这么大的够用吗
她是你妈妈吗	她是你妈妈吗
有啥子不对吗	有什么不对吗
这就是全部吗	这就是全部吗
这是你们的苹果吗	这是你们的苹果吗
这莫得结果	这没有结果
游泳很简单	游泳很简单
它真的很便宜	它真的很便宜
它变糟老	它变糟了
那不是我的错	那不是我的错
天快要下雨老	天快要下雨了
旅行是令人快落的	旅行是令人快乐的
旅行是乐事	旅行是乐事
它会好转的	它会好转的
这个不重要	这个不重要
这不重要	这不重要
这不实用	这不实用
今天下雪	今天下雪
这太贵老	这太贵了
就让汤姆说吧	就让汤姆说吧
不要踩草地	不要踩草地
知识就是力量	知识就是力量
离我的车远一点	离我的车远一点
不要碰我的车	不要碰我的车
让我来处理	让我来处理
现实点嘛	现实点吧
我们离婚嘛	我们离婚吧
我们在这里下车嘛	我们在这里下车吧
我们不要看电视嘛	我们不要看电视吧
让我们放轻松噻	让我们放轻松吧
看看我的新车	看看我的新车
看那个房子	看那个房子
快看那个烟	快看那个烟
看看发生老啥子	看看发生了什么
爱不存在	爱不存在
玛丽的腿很漂亮	玛丽的腿很漂亮
玛丽有一双美腿	玛丽有一双美腿
我可以用支票付吗	我可以用支票付吗
也许您有道理	也许您有道理
我父亲变老老	我父亲变老了
我的手烧伤老	我的手烧伤了
我的腿还是很痛	我的腿还是很痛
我的房间面向东边	我的房间面向东边
莫得人能帮我	没有人能帮我
莫得人会看到我们	没有人会看到我们
没人能阻止我	没人能阻止我
莫得人受伤	没有人受伤
哪个也没在看她	谁也没在看她
啥子也没少	什么也没少
现在它是官方的	现在它是官方的
现在等一哈	现在等一下
要听老师的话	要听老师的话
哦那太糟糕老	哦那太糟糕了
请穿衣服	请穿衣服
请让我们晓得	请让我们知道
请唱一首歌	请唱一首歌
把书放在那里	把书放在那里
放下你的枪	放下你的枪
土星是一颗行星	土星是一颗行星
她痛哭老起来	她痛哭了起来
她很聪明	她很聪明
她很可爱	她很可爱
她爱孩子	她爱孩子
她需要我们的帮忙	她需要我们的帮忙
她戴上老她的帽子	她戴上了她的帽子
她讲中文	她讲中文
她在赶时间	她在赶时间
她赢得一切老	她赢得一切了
她是Tom的姐妹	她是Tom的姐妹
她是我的同学	她是我的同学
她只是个孩子	她只是个孩子
给我个例子	给我个例子
有人在吃东西	有人在吃东西
不要走在草地上	不要走在草地上
不要随便开玩笑	不要随便开玩笑
别开玩笑老	别开玩笑了
告诉我该做啥子	告诉我该做什么
那真有趣	那真有趣
那是我们的学校	那是我们的学校
那是好几年前	那是好几年前
真是个好主意	真是个好主意
那是一个好主意	那是一个好主意
那没啥子大不了的	那没什么大不了的
这不是我的婆娘	这不是我的妻子
真好	真好
我就喜欢它	我就喜欢它
那就是我想要的	那就是我想要的
这地区很安静	这地区很安静
这个男孩吃面包	这个男孩吃面包
汽车发生故障老	汽车发生故障了
咖啡是冷的	咖啡是冷的
这只乌鸦飞走老	这只乌鸦飞走了
危险已过切	危险已过去
玻璃脏老	玻璃脏了
锁坏老	锁坏了
飞机准备好老	飞机准备好了
问题是汤姆	问题是汤姆
夏天过切老	夏天过去了
轮胎漏气老	轮胎漏气了
我们的车走老	我们的车走了
莫得错误	没有错误
这些狗很大	这些狗很大
这些一定是假的	这些一定是假的
他们全都来老	他们全都来了
他们没听	他们没听
他们没付我钱	他们没付我钱
他们没看见我们	他们没看见我们
他们不喜欢我	他们不喜欢我
他们迫使我出来	他们迫使我出来
他们永不言弃	他们永不言弃
他们是那么年轻	他们是那么年轻
他们不会通过的	他们不会通过的
他们在一起工作	他们在一起工作
这本书小	这本书小
这本书是你的	这本书是你的
这本书很容易	这本书很容易
这把椅子很丑	这把椅子很丑
这个表是我的	这个表是我的
这房子是我的	这房子是我的
这是玛丽的狗	这是玛丽的狗
这是医院	这是医院
这是我所知道的	这是我所知道的
这就是错的	这就是错的
这可真好	这可真好
这是令人吃惊的	这是令人吃惊的
这不是西班牙语	这不是西班牙语
这不是老虎	这不是老虎
这不是给你的	这不是给你的
这个故事是真的	这个故事是真的
那些是我的裤子	那些是我的裤子
那些狗都很大	那些狗都很大
今天是五号	今天是五号
汤姆放弃老希望	汤姆放弃了希望
汤姆要食物	汤姆要食物
汤姆在战斗中死老	汤姆在战斗中死了
汤姆服从命令	汤姆服从命令
汤姆有辆旧车	汤姆有辆旧车
Tom莫得礼貌	Tom没有礼貌
Tom有三只猫	Tom有三只猫
汤姆是个好厨师	汤姆是个好厨师
汤姆总是迟到	汤姆总是迟到
汤姆也来	汤姆也来
汤姆也在哭	汤姆也在哭
汤姆要发疯	汤姆要发疯
汤姆更活跃	汤姆更活跃
汤姆现在是认真的	汤姆现在是认真的
汤姆还是不安	汤姆还是不安
Tom独自在那	Tom独自在那
汤姆不是天使	汤姆不是天使
汤姆喜欢游泳	汤姆喜欢游泳
汤姆拿我开心	汤姆拿我开心
汤姆说他会等	汤姆说他会等
汤姆教法语	汤姆教法语
汤姆在外面等	汤姆在外面等
汤姆想报仇	汤姆想报仇
汤姆不渴	汤姆不渴
汤姆的门开着	汤姆的门开着
关灯	关灯
就等一哈儿	就等一会儿
她的故事是真的吗	她的故事是真的吗
他的故事是真的吗	他的故事是真的吗
我们都睡着老	我们都睡着了
我们反对战争	我们反对战争
我们不能在这里谈	我们不能在这里谈
我们没有打断	我们没有打断
我们不卖生啤酒	我们不卖生啤酒
我们不相信汤姆	我们不相信汤姆
我们有许多目标	我们有许多目标
我们有三个娃儿	我们有三个孩子
我们啥子都晓得	我们什么都知道
我们彼此相爱	我们彼此相爱
我们爱我们的学校	我们爱我们的学校
我们需要帮助	我们需要帮助
我们应该坐下	我们应该坐下
我们学老英语	我们学了英语
我们想回家	我们想回家
我们想听听	我们想听听
我们快破产老	我们快破产了
我们很保守	我们很保守
他和我同岁	他和我同岁
我们被耍老	我们被耍了
我们已经原谅你老	我们已经原谅你了
你是士兵吗	你是士兵吗
那么多钢笔	那么多钢笔
多么强的风啊	多么强的风啊
我真是个哈儿	我真是个白痴
你在做啥子	你在做什么
老虎吃啥子东西	老虎吃什么东西
这儿发生老啥子事	这儿发生了什么事
然后发生老啥子事	然后发生了什么事
那是啥子	那是什么
刚刚发生老啥子	刚刚发生了什么
你将拥有啥子	你将拥有什么
你会做啥子	你会做什么
你在说啥子	你在说什么
这个袋子里是啥子	这个袋子里是什么
你啷个老	你怎么了
你有啥子建议呢	你有什么建议呢
你在哪读书	你在哪读书
他住在哪里	他住在哪里
他在哪里工作	他在哪里工作
哪里疼	哪里疼
我们应该切哪里	我们应该去哪里
鞋子在哪儿	鞋子在哪儿
锤子在哪里	锤子在哪里
哪顶帽子是你的	哪顶帽子是你的
哪个杯子是你的	哪个杯子是你的
哪本是你的书	哪本是你的书
哪本是你们的书	哪本是你们的书
哪本是您的书	哪本是您的书
哪本书是您的	哪本书是您的
哪本书是你们的	哪本书是你们的
那些家伙是哪个	那些家伙是谁
那人哪个啊	那人谁啊
哪个拿老钱	谁拿了钱
哪个碰老我的枪	谁碰了我的枪
这辆自行车是哪个的	这辆自行车是谁的
这是哪个的书	这是谁的书
这书是哪个的	这书是谁的
那是哪个的环	那是谁的环
你为啥子哭	你为什么哭
你为啥子这么生气	你为什么这么生气
你为啥子不能来	你为什么不能来
你为啥子需要它	你为什么需要它
你为啥子在那里	你为什么在那里
为啥子要担心	为什么要担心
我会留疤吗	我会留疤吗
你可以走老	你可以走了
您非常勇敢	您非常勇敢
你非常勇敢	你非常勇敢
你没受到邀请	你没受到邀请
你坏老规矩	你坏了规矩
你不能这么说	你不能这么说
你干得很好	你干得很好
你别黑我们	你别吓我们
你的皮肤真好	你的皮肤真好
你知道我是正确的	你知道我是正确的
你喜欢大象	你喜欢大象
你看上去很好	你看上去很好
你看上去很苍白	你看上去很苍白
你犯老个错误	你犯了个错误
你可能会见到他	你可能会见到他
你一定是开玩笑	你一定是开玩笑
你应该知道的	你应该知道的
你最好快点	你最好快点
你会困惑	你会困惑
你会东山再起的	你会东山再起的
你是个好厨师	你是个好厨师
你一直忙	你一直忙
你总是迟到	你总是迟到
你是个乐观主义者	你是个乐观主义者
你是对的	你是对的
你还年轻	你还年轻
你仍然很年轻	你仍然很年轻
你真是个傻子	你真是个傻子
“相信我”他说	“相信我”他说
鲸鱼是哺乳动物	鲸鱼是哺乳动物
我是一个好老师吗	我是一个好老师吗
回答我的问题	回答我的问题
回答问题	回答问题
你们在哭吗	你们在哭吗
您会开车吗	您会开车吗
你真的会游泳吗	你真的会游泳吗
随时再来	随时再来
我能试一哈这个吗	我能试一下这个吗
你能在这里签名吗	你能在这里签名吗
摧毁这个寺庙	摧毁这个寺庙
你喝咖啡吗	你喝咖啡吗
你切教堂吗	你去教堂吗
你咳嗽吗	你咳嗽吗
你发烧老吗	你发烧了吗
你有刀吗	你有刀吗
你知道我的名字吗	你知道我的名字吗
你喜欢英语吗	你喜欢英语吗
你喜欢菠菜吗	你喜欢菠菜吗
你会讲法语吗	你会讲法语吗
你想知道吗	你想知道吗
汤姆有工作吗	汤姆有工作吗
不要掉老这个杯子	不要掉了这个杯子
莫让汤姆走老	别让汤姆走了
莫听她的	别听她的
不要站在我身边	不要站在我身边
你不知道那件事吗	你不知道那件事吗
干柴烧得旺	干柴烧得旺
度假愉快	度假愉快
分秒必争	分秒必争
每个人都认识她	每个人都认识她
大家都是这样想的	大家都是这样想的
一切看上切正常	一切看上去正常
很少人这么认为	很少人这么认为
今天鱼很便宜	今天鱼很便宜
给我支香烟吧	给我支香烟吧
Tom疯老吗	Tom疯了吗
周末愉快	周末愉快
你曾经被开除过吗	你曾经被开除过吗
他接受老我的主意	他接受了我的主意
他终于出现老	他终于出现了
他爬上老富士山	他爬上了富士山
我的病给他治好老	我的病给他治好了
他做这个是为老钱	他做这个是为了钱
他不知道	他不知道
他不喜欢我们	他不喜欢我们
他开车速度非常快	他开车速度非常快
他加入老陆军	他加入了陆军
他有个大家庭	他有个大家庭
他有一张圆脸	他有一张圆脸
他有自己的房间	他有自己的房间
他讨厌坐飞机旅行	他讨厌坐飞机旅行
他是个有教养的人	他是个有教养的人
他今天在家	他今天在家
他很擅长橄榄球	他很擅长橄榄球
他不信教	他不信教
他在演奏音乐	他在演奏音乐
他正在散步	他正在散步
他扯把子	他说谎
他很英俊	他很英俊
他仰躺	他仰躺
他一小时前走老	他一小时前走了
他可能不高兴	他可能不高兴
他举起老他的手	他举起了他的手
他向那位女士问好	他向那位女士问好
他坐在长凳上	他坐在长凳上
他看起来很有钱	他看起来很有钱
他每天刮胡子	他每天刮胡子
他应该感谢您	他应该感谢您
他被选为队长	他被选为队长
他非常有耐心	他非常有耐心
他工作很努力	他工作很努力
他写老这份报告	他写了这份报告
他怕狗	他怕狗
他总是在笑	他总是在笑
他在全力以赴	他在全力以赴
他是长子	他是长子
他是最年长的儿子	他是最年长的儿子
她儿子是个天才	她儿子是个天才
这是你零钱	这是你零钱
我多么想念你	我多么想念你
泰国菜啷个样	泰国菜怎么样
你现在感觉如何	你现在感觉如何
我们有多远老	我们有多远了
这间动物园多久老	这间动物园多久了
你儿子几岁	你儿子几岁
钓鱼啷个样	钓鱼怎么样
这研究会啷个样	这研究会怎么样
我总是用功读书	我总是用功读书
我是一名电工	我是一名电工
我跟她订婚老	我跟她订婚了
我今天在东京	我今天在东京
我到达伦敦老	我到达伦敦了
我匆忙的吃老午餐	我匆忙的吃了午餐
我盖老栋新房子	我盖了栋新房子
我三点钟可以来	我三点钟可以来
我也能帮你	我也能帮你
我能看到光线	我能看到光线
我会说中文	我会说中文
我会讲英语	我会讲英语
我随时可以开始	我随时可以开始
我这回能赢	我这回能赢
我买不起那个	我买不起那个
我找不到我的笔	我找不到我的笔
我清理老桌子	我清理了桌子
我来自英国	我来自英国
我继续唱歌	我继续唱歌
我继续工作	我继续工作
我不同意你的看法	我不同意你的看法
我不怕死	我不怕死
我不喜欢电影	我不喜欢电影
我不喜欢学校	我不喜欢学校
我不喜欢夏天	我不喜欢夏天
我不喜欢冬天	我不喜欢冬天
我哪个也不需要	我谁也不需要
我看不出为啥子不	我看不出为什么不
我不想吃	我不想吃
我今晚感觉良好	我今晚感觉良好
我忘老问汤姆	我忘了问汤姆
我忘老问他	我忘了问他
我忘记问他老	我忘记问他了
我烧得很厉害	我烧得很厉害
我切过罗马	我去过罗马
我的嘴裂开老	我的嘴裂开了
我该切睡觉老	我该去睡觉了
我该上床老	我该上床了
我得留在家	我得留在家
我听见她唱歌老	我听见她唱歌了
我只想休息一哈	我只想休息一下
我养老一只母猫	我养了一只母猫
我知道你做老啥子	我知道你做了什么
我知道她在哪里	我知道她在哪里
我知道你难过	我知道你难过
我喜欢火龙果	我喜欢火龙果
我喜欢他们每一个	我喜欢他们每一个
我喜欢吃水果	我喜欢吃水果
我很喜欢电影	我很喜欢电影
我喜欢散步	我喜欢散步
我住在这区	我住在这区
我住得太远老	我住得太远了
我很爱喝茶	我很爱喝茶
我从没玩过高尔夫	我从没玩过高尔夫
我注意到一个图案	我注意到一个图案
我常常感冒	我常常感冒
我经常吃鸡	我经常吃鸡
我迅速地吃老午饭	我迅速地吃了午饭
我真的很倒霉	我真的很倒霉
我真的不会唱	我真的不会唱
我真的得走老	我真的得走了
我记得这张地图	我记得这张地图
我去年退休老	我去年退休了
我也说法语	我也说法语
我和朋友们交谈	我和朋友们交谈
我对汤姆说我很好	我对汤姆说我很好
我试着要告诉你	我试着要告诉你
我想耍女朋友	我想找女朋友
我已经累老	我已经累了
我生于京都	我生于京都
我昨天生病老	我昨天生病了
我真是饿老	我真是饿了
我被烦死老	我被烦死了
我当时不孤单	我当时不孤单
我会再告一哈	我会再试一次
我希望我会游泳	我希望我会游泳
但愿我还年轻	但愿我还年轻
我不会保持沉默的	我不会保持沉默的
我不会上当的	我不会上当的
我在一家工厂工作	我在一家工厂工作
我全写下来老	我全写下来了
我开车送你回家	我开车送你回家
我一会儿就来	我一会儿就来
我让你来决定	我让你来决定
我会让你幸福的	我会让你幸福的
我六点半回来	我六点半回来
我是汤姆的助手	我是汤姆的助手
我怕死	我怕死
我和他同年	我和他同年
我就指望你老	我就指望你了
我为你疯狂	我为你疯狂
我在找你	我在找你
我一点也不累	我一点也不累
我不是你们的妈妈	我不是你们的妈妈
我不是你母亲	我不是你母亲
莫得你我很悲伤	没有你我很悲伤
我被工作困住老	我被工作困住了
我比你高	我比你高
我今天很忙	我今天很忙
我现在非常饿	我现在非常饿
我在等他	我在等他
我进过监狱	我进过监狱
我把票弄丢老	我把票弄丢了
我错过老太多	我错过了太多
我见过汤姆光着	我见过汤姆光着
汤姆在帮玛丽吗	汤姆在帮玛丽吗
那边有人吗	那边有人吗
离这儿远吗	离这儿远吗
那是我们的问题吗	那是我们的问题吗
那是车站吗	那是车站吗
这真是真的吗	这真是真的吗
这是你的家人吗	这是你的家人吗
这是你的铅笔吗	这是你的铅笔吗
它有危险	它有危险
它不容易	它不容易
要下雪老	要下雪了
它可能从没发生过	它可能从没发生过
昨天下雨老	昨天下雨了
自作自受	自作自受
它很好耍	它很好玩
天要黑老	天要黑了
真是物美价廉	真是物美价廉
都是你的错	都是你的错
它冷得像冰一样	它冷得像冰一样
太棒老	太棒了
这么说是安全的	这么说是安全的
它是值得等待的	它是值得等待的
继续直行	继续直行
睁大你的眼睛	睁大你的眼睛
今天就到此为止吧	今天就到此为止吧
让我们切看电影	让我们去看电影
让我们保持联络	让我们保持联络
让我们来打棒球吧	让我们来打棒球吧
举起你的右臂	举起你的右臂
爱就像氧气	爱就像氧气
玛丽舞跳得很好	玛丽舞跳得很好
玛丽很漂亮	玛丽很漂亮
我可以说些啥子吗	我可以说些什么吗
水星是一颗行星	水星是一颗行星
请再给我一点咖啡	请再给我一点咖啡
我的背还在痛	我的背还在痛
我女朋友哭老	我女朋友哭了
我家很远	我家很远
我的脖子还疼	我的脖子还疼
我的钱包被抢老	我的钱包被抢了
我房间是个猪窝	我房间是个猪窝
我喉咙很干	我喉咙很干
饮酒者不准禁入	饮酒者不准禁入
莫得人看过神	没有人看过神
现在该你发球	现在该你发球
我们中的一个得走	我们中的一个得走
鸵鸟不会飞	鸵鸟不会飞
纸烧得快	纸烧得快
人们就是爱说话	人们就是爱说话
请整理床铺	请整理床铺
请说慢一点	请说慢一点
请说慢一些	请说慢一些
请祝我好运	请祝我好运
物价上涨老	物价上涨了
把球传给我	把球传给我
后天见	后天见
她没有出现	她没有出现
她不这么想	她不这么想
她终于做到老	她终于做到了
她给老我一支手表	她给了我一支手表
她的体重减轻老	她的体重减轻了
她大约跟我同年纪	她大约跟我同年纪
她还是个小孩儿	她还是个小孩儿
她继续工作	她继续工作
她给我沏老茶	她给我沏了茶
她给我泡老茶	她给我泡了茶
她切散步老	她去散步了
她很努力工作	她很努力工作
有人在监视	有人在监视
别进我的房间	别进我的房间
停止大声说话	停止大声说话
把你的袜子脱老	把你的袜子脱了
这个男孩子在跑步	这个男孩子在跑步
那个男孩在跑步	那个男孩在跑步
这不是我拿手的	这不是我拿手的
那是灾难	那是灾难
那是我的错	那是我的错
那不太坏	那不太坏
那是汤姆的妈妈	那是汤姆的妈妈
这是一首很棒的诗	这是一首很棒的诗
那是例外	那是例外
那是一个仿造品	那是一个仿造品
那是你的想法	那是你的想法
男孩子们保持安静	男孩子们保持安静
这颗钮扣脱落老	这颗钮扣脱落了
这只猫很可爱	这只猫很可爱
那猫没死	那猫没死
农作物需要雨水	农作物需要雨水
文件已损坏	文件已损坏
火警警报响老	火警警报响了
湖冻冰老	湖冻冰了
月光在照耀着	月光在照耀着
文件被风刮起来	文件被风刮起来
这画不错	这画不错
天空很清朗	天空很清朗
天暗老下来	天暗了下来
列车已经出发	列车已经出发
树是绿的	树是绿的
这里没人	这里没人
他们有马	他们有马
他们毁老我的生活	他们毁了我的生活
他们震惊老	他们震惊了
他们不会找到汤姆	他们不会找到汤姆
他们会感激	他们会感激
他们不理我	他们不理我
这是件坏事	这是件坏事
这是我女儿	这是我女儿
这是我的财产	这是我的财产
这是他们家	这是他们家
这就是我想要的	这就是我想要的
这让我愤怒	这让我愤怒
这让我开心	这让我开心
这张桌子很重	这张桌子很重
这帮不了你	这帮不了你
不可杀人	不可杀人
汤姆买老张票	汤姆买了张票
汤姆找不到玛丽	汤姆找不到玛丽
汤姆不会系领带	汤姆不会系领带
汤姆关心你	汤姆关心你
汤姆换老衣服	汤姆换了衣服
Tom处理老卡片	Tom处理了卡片
汤姆不喜欢我	汤姆不喜欢我
Tom莫得孩子	Tom没有孩子
汤姆冷静下来老	汤姆冷静下来了
汤姆是聪明的孩子	汤姆是聪明的孩子
汤姆是位政治家	汤姆是位政治家
汤姆非常虚弱	汤姆非常虚弱
汤姆在吹嘘	汤姆在吹嘘
汤姆在阁楼里	汤姆在阁楼里
汤姆在这栋房子里	汤姆在这栋房子里
汤姆在家里	汤姆在家里
汤姆在努力工作	汤姆在努力工作
汤姆知道它结束老	汤姆知道它结束了
汤姆喜欢辣咖哩	汤姆喜欢辣咖哩
汤姆做老个三明治	汤姆做了个三明治
汤姆需要钱	汤姆需要钱
汤姆点头同意	汤姆点头同意
汤姆欠我们个情	汤姆欠我们个情
汤姆打算回来	汤姆打算回来
汤姆坐在玛丽旁边	汤姆坐在玛丽旁边
汤姆看见玛丽在哭	汤姆看见玛丽在哭
汤姆说他累老	汤姆说他累了
汤姆应该要被开除	汤姆应该要被开除
汤姆应该高兴	汤姆应该高兴
汤姆应该感谢我	汤姆应该感谢我
汤姆开始唱歌	汤姆开始唱歌
汤姆站在我后面	汤姆站在我后面
汤姆星期五闲着	汤姆星期五闲着
汤姆拍老这张照	汤姆拍了这张照
汤姆从不高兴	汤姆从不高兴
汤姆在名单上	汤姆在名单上
汤姆非常害怕	汤姆非常害怕
汤姆当时非常害怕	汤姆当时非常害怕
汤姆不会来老	汤姆不会来了
汤姆在波士顿工作	汤姆在波士顿工作
汤姆写老两本书	汤姆写了两本书
汤姆的妈妈去世老	汤姆的妈妈去世了
汤姆莫得呼吸老	汤姆没有呼吸了
现在休息一哈	现在休息一下
雨伞卖得好	雨伞卖得好
七点叫醒我	七点叫醒我
不浪费则不匮乏	不浪费则不匮乏
我们都有秘密	我们都有秘密
我们是好朋友	我们是好朋友
我们在吃午餐	我们在吃午餐
我们做不到	我们做不到
我们自己做的	我们自己做的
我们哪个也没看见	我们谁也没看见
我们正在吃苹果	我们正在吃苹果
我们在吃晚餐	我们在吃晚餐
我们不在波士顿	我们不在波士顿
我们还是紧张	我们还是紧张
我们没有做好	我们没有做好
欢迎来到我们家	欢迎来到我们家
啷个办	怎么办
你们叫啥子名字	你们叫什么名字
他问你啥子	他问你什么
你回答老啥子	你回答了什么
你在这里做啥子	你在这里做甚么
我该带些啥子	我该带些什么
你想要啥子	你想要什么
你在看啥子	你在看什么
汤姆给老我们啥子	汤姆给了我们什么
今天几号	今天几号
出啥子事老宝贝	出什么事了宝贝
你有啥子问题	你有什么问题
你啥子时候买的	你什么时候买的
它啥子时候到	它什么时候到
你啥子时候离开	你什么时候离开
你切哪儿	你去哪儿
你要切哪里	你要去哪里
哪里出切	哪里出去
你们切哪里	你们去哪里
你一直在哪里	你一直在哪里
你家在哪里	你家在哪里
您的家在哪	您的家在哪
你们家在哪	你们家在哪
哪一个最简单	哪一个最简单
你和哪个说话呢	你和谁说话呢
那个老男人是哪个	那个老男人是谁
请问这是哪个	请问这是谁
哪个是你老师	谁是你老师
这是哪个的衬衫	这是谁的衬衫
为啥子我还在这里	为什么我还在这里
你为啥子那样说	你为什么那样说
你为啥子不做	你为什么不做
为啥子天是蓝的	为什么天是蓝的
那为啥子不好	那为啥子不好
你说得很对	你说得很对
你触犯老规则	你触犯了规则
你可以依靠它	你可以依靠它
你可以依靠他	你可以依靠他
你现在可以住口老	你现在可以住口了
你有选择	你有选择
你们疯老嘛	你们疯了吧
您有很多书	您有很多书
你有许多书	你有许多书
您有一些书	您有一些书
你有一些书	你有一些书
你看上切非常累	你看上去非常累
您可以随便切哪儿	您可以随便去哪儿
你可以随便切哪儿	你可以随便去哪儿
你现在可以回家老	你现在可以回家了
你不能进来	你不能进来
你需要个假期	你需要个假期
你需要保护	你需要保护
你应该试哈这个	你应该试试这个
你最好不要切	你最好不要去
你令人难以抗拒	你令人难以抗拒
您不是医生	您不是医生
你还不太晚	你还不太晚
你太漂亮老	你太漂亮了
你是囚犯	你是囚犯
你太大方老	你太大方了
你爸爸很高	你爸爸很高
你的头发很漂亮	你的头发很漂亮
你的鞋在这儿	你的鞋在这儿
你的在那儿呢	你的在那儿呢
需要准许	需要准许
几乎每个人都来老	几乎每个人都来了
那些是爆炸物吗	那些是爆炸物吗
我们将会输老吗	我们将会输了吗
你是汤姆的母亲吗	你是汤姆的母亲吗
你工作很忙吗	你工作很忙吗
你在跟着我吗	你在跟着我吗
你切还是不切	你去还是不去
你的手干净吗	你的手干净吗
给我一条干毛巾	给我一条干毛巾
但你不在那里	但你不在那里
我能问个问题吗	我能问个问题吗
他会讲英语吗	他会讲英语吗
我们能不打老吗	我们能不打了吗
您会骑马吗	您会骑马吗
猫讨厌被弄湿	猫讨厌被弄湿
孩子们需要关爱	孩子们需要关爱
人要衣装	人要衣装
下周再来	下周再来
我错过派对老吗	我错过派对了吗
Tom有说啥子吗	Tom有说什么吗
有人打汤姆老吗	有人打汤姆了吗
发生老啥子事吗	发生了什么事吗
你起床早吗	你起床早吗
你切学校老吗	你去学校了吗
到别处切做	到别处去做
你常常外食吗	你常常外食吗
你六点起床吗	你六点起床吗
你有照相机吗	你有照相机吗
你有车库吗	你有车库吗
你有孩子吗	你有孩子吗
你有兄弟姐妹吗	你有兄弟姐妹吗
你很了解汤姆吗	你很了解汤姆吗
你喜欢购物吗	你喜欢购物吗
你喜欢游泳吗	你喜欢游泳吗
你每天都跑步吗	你每天都跑步吗
你会说中文吗	你会说中文吗
您学英语吗	您学英语吗
你学英语吗	你学英语吗
你想要啥子吗	你想要什么吗
汤姆打网球吗	汤姆打网球吗
有人认识汤姆吗	有人认识汤姆吗
别这么粗心	别这么粗心
不要那么幼稚	不要那么幼稚
莫走极端	别走极端
莫离开房间	别离开房间
不要打开你的书	不要打开你的书
莫想阻止我	别想阻止我
不要担心它	不要担心它
不要担心我	不要担心我
一切都很顺利	一切都很顺利
终于星期五老	终于星期五了
回到你的座位	回到你的座位
你在吃东西吗	你在吃东西吗
你吃过午饭老吗	你吃过午饭了吗
你做完老吗	你做完了吗
他接受老她的礼物	他接受了她的礼物
他担任我的向导	他担任我的向导
他拯救老我	他拯救了我
他自杀老	他自杀了
他不喜欢吃鱼	他不喜欢吃鱼
他面有饥色	他面有饥色
他收入可观	他收入可观
他的视力不佳	他的视力不佳
他有两个女儿	他有两个女儿
他是个日本少年	他是个日本少年
他一直与我同在	他一直与我同在
他在生你的气	他在生你的气
他很容易迟到	他很容易迟到
他和她一样高	他和她一样高
他充满活力	他充满活力
他很敏感	他很敏感
他戴着手套	他戴着手套
他不是美国人	他不是美国人
他会游泳	他会游泳
他喜欢看电视	他喜欢看电视
他可能病老	他可能病了
他收起老他的玩具	他收起了他的玩具
他跑进房间内	他跑进房间内
他说得很大声	他说得很大声
他学习非常努力	他学习非常努力
他以前住在这儿	他以前住在这儿
他想亲她	他想亲她
他被选为市长	他被选为市长
他之前坐在这里	他之前坐在这里
他切老商店	他去了商店
他很快就会回来的	他很快就会回来的
他给我写老封信	他给我写了封信
他是个网球球手	他是个网球球手
他准会忘	他准会忘
他正吃着一个苹果	他正吃着一个苹果
他比我年轻	他比我年轻
火车来老	火车来了
嘿你请稍候	嘿你请稍候
三明治啷个样	三明治怎么样
你啷个能那么说	你怎么能那么说
这个洞多深	这个洞多深
富士山有多高	富士山有多高
你出价多少	你出价多少
你周末过得啷个样	你周末过得怎么样
我已经道歉老	我已经道歉了
我是这里的外地人	我是这里的外地人
我指望你老	我指望你了
我四点要离开	我四点要离开
我一点都不好	我一点都不好
我不擅长画画	我不擅长画画
我相信那个故事	我相信那个故事
我摔断老右腿	我摔断了右腿
我几乎看不见你	我几乎看不见你
我会说一点儿	我会说一点儿
我买不起车子	我买不起车子
我不能相信	我不能相信
我也不会做	我也不会做
我不太确定	我不太确定
我不能关掉它	我不能关掉它
我现在不能告诉你	我现在不能告诉你
我不能等你	我不能等你
我不能永远地等	我不能永远地等
我不能离开汤姆	我不能离开汤姆
我没有预定这个	我没有预定这个
我啥子事都没有做	我什么事都没有做
我没有独自做	我没有独自做
我不喜欢大城市	我不喜欢大城市
我们不相信那个	我们不相信那个
我不歧视人	我不歧视人
我没明白那个笑话	我没明白那个笑话
我不切学校	我不去学校
我不喜欢英语	我不喜欢英语
我不喜欢科学	我不喜欢科学
我不会说德语	我不会说德语
我不想游泳	我不想游泳
我不想等	我不想等
他不爱劳动	他不爱劳动
我偶然找到老它	我偶然找到了它
我猜你是对的	我猜你是对的
昨晚我玩得开心	昨晚我玩得开心
我有工作给你	我有工作给你
我有很多狗	我有很多狗
我喉咙痛	我喉咙痛
我有那么多的主意	我有那么多的主意
我有三台摄影机	我有三台摄影机
我有你需要的	我有你需要的
我刚刚切到手指老	我刚刚切到手指了
我只是不喜欢它	我只是不喜欢它
我非常了解她	我非常了解她
我晓得你的意思	我知道你的意思
我晓得哪个喜欢汤姆	我知道谁喜欢汤姆
我让门开着	我让门开着
我喜欢吃苹果	我喜欢吃苹果
我喜欢独自行走	我喜欢独自行走
我非常喜欢你	我非常喜欢你
我做老点改动	我做了点改动
昨天我遇见了玛丽	昨天我遇见了玛丽
我得切工作老	我得去工作了
我需要学习数学	我需要学习数学
我需要作笔记	我需要作笔记
我不再爱汤姆老	我不再爱汤姆了
我已经不爱他老	我已经不爱他了
我欠汤姆钱	我欠汤姆钱
我欠老很多钱	我欠了很多钱
我付老两百元含税	我付了两百元含税
我付了他钱	我付了他钱
我拒绝了报价	我拒绝了报价
我记得这个单词	我记得这个单词
我说开门	我说开门
我本应婉拒	我本应婉拒
我有时看电视	我有时看电视
我大概懂老	我大概懂了
我想我懂老	我想我懂了
我认为我明白老	我认为我明白了
我认为它错老	我认为它错了
我看那糟透老	我看那糟透了
我想这是真的	我想这是真的
我觉得你在撒谎	我觉得你在撒谎
我认为你准备好老	我认为你准备好了
我走上山老	我走上山了
我要几个土豆	我要几个土豆
我想要另一个	我想要另一个
我想做个派	我想做个派
我想学数学	我想学数学
我想阻止汤姆	我想阻止汤姆
我在剧场	我在剧场
我在另一个地方	我在另一个地方
我加入老海军	我加入了海军
我会和你一起切	我会和你一起去
我希望我比较高	我希望我比较高
我祝您好运	我祝您好运
我承认我错老	我承认我错了
我会请Tom等	我会请Tom等
我会看着你	我会看着你
我会梦到你的	我会梦到你的
我会给你一本书	我会给你一本书
我会载你一程	我会载你一程
我会帮你逃跑的	我会帮你逃跑的
我会给你证明的	我会给你证明的
我会关照它的	我会关照它的
我是个老实人	我是个老实人
我在买一辆新车	我在买一辆新车
我在关门	我在关门
我在回家汤姆	我在回家汤姆
我和他是朋友	我和他是朋友
我很高兴我在那里	我很高兴我在那里
我在这里出差	我在这里出差
我来这里帮你	我来这里帮你
我今天赶时间	我今天赶时间
我爱上她老	我爱上她了
我只是个大众脸	我只是个大众脸
我学英文	我学英文
我根本不累	我根本不累
我不回切	我不回去
我听老感到抱歉	我听了感到抱歉
我确定他们会赢	我确定他们会赢
我相信他们会赢	我相信他们会赢
我就是你要找的人	我就是你要找的人
我厌倦老跳舞	我厌倦了跳舞
我正跟她一起走	我正跟她一起走
我乐意分享	我乐意分享
我吃老一个苹果	我吃了一个苹果
我给你带老一个	我给你带了一个
我赢得老第一名	我赢得了第一名
他的脉搏正常吗	他的脉搏正常吗
有时间表吗	有时间表吗
它现在归我老	它现在归我了
这看上切像个蛋	这看上去像个蛋
这让我感到沮丧	这让我感到沮丧
雨下老一周	雨下了一周
这看起来似曾相识	这看起来似曾相识
它是封长信	它是封长信
小菜一碟	小菜一碟
这是浪费时间	这是浪费时间
我对此一窍不通	我对此一窍不通
全是汤姆的错	全是汤姆的错
这是场长久的战争	这是场长久的战争
它莫得那么简单	它没有那么简单
这没啥子要紧的	这没什么要紧的
有点奇怪	有点奇怪
它在桌下	它在桌下
让我说一件事情	让我说一件事情
打扫我们的房间吧	打扫我们的房间吧
让我们切俱乐部吧	让我们去俱乐部吧
让我们祈盼她会来	让我们祈盼她会来
我们做多一点	我们做多一点
我们不要讨论它	我们不要讨论它
玛丽弹钢琴	玛丽弹钢琴
我可以出切玩吗	我可以出去玩吗
我可以弹钢琴吗	我可以弹钢琴吗
大概我们需要交谈	大概我们需要交谈
也许你会成功	也许你会成功
我在流眼泪	我在流眼泪
我爸爸变老老	我爸爸变老了
我爸种水稻	我爸种水稻
父亲很健康	父亲很健康
我的牙龈流血	我的牙龈流血
我的头要炸老	我的头要炸了
我的表停老	我的表停了
没消息就是好消息	没消息就是好消息
莫得别的人受伤	没有别的人受伤
莫得人生还	没有人生还
没人支持她	没人支持她
柳橙汁麻烦你	柳橙汁麻烦你
我们的车误点老	我们的车误点了
人有两只脚	人有两只脚
请吃点蛋糕	请吃点蛋糕
请把门锁上	请把门锁上
请把门打开	请把门打开
请开门	请开门
请关上门	请关上门
请考虑一哈	请考虑一下
按两下铃	按两下铃
把你的武器放下	把你的武器放下
在派对上见	在派对上见
她给老他一块表	她给了他一块表
她给老他车	她给了他车
她早上7点起床	她早上7点起床
她有一颗纯洁的心	她有一颗纯洁的心
她有张圆脸	她有张圆脸
她有十个孩子	她有十个孩子
她戴着一顶帽子	她戴着一顶帽子
她提高老她的嗓音	她提高了她的嗓音
她非常恨他	她非常恨他
她坐在长椅上	她坐在长椅上
她寄给我一封信	她寄给我一封信
她掴老他的脸	她掴了他的脸
她想拥抱他	她想拥抱他
她被车撞老	她被车撞了
她是个安静的人	她是个安静的人
她和汤姆一样忙	她和汤姆一样忙
她是我最好的朋友	她是我最好的朋友
她年纪比汤姆大	她年纪比汤姆大
她非常漂亮	她非常漂亮
我们应该要担心吗	我们应该要担心吗
有啥子事发生老	有什么事发生了
躲雨	躲雨
别被雨淋老	别被雨淋了
那自行车是我的	那自行车是我的
那就发生在我身上	那就发生在我身上
那个肉是鸡肉	那个肉是鸡肉
那是一个月前老	那是一个月前了
那真整洁	那真整洁
那是很多钱	那是很多钱
那是我的字典	那是我的字典
那很明显	那很明显
宝宝正在睡觉	宝宝正在睡觉
箱子不是空的	箱子不是空的
草地看来不错	草地看来不错
这房子正在燃烧着	这房子正在燃烧着
这房子闹鬼	这房子闹鬼
灯莫得亮着	灯没有亮着
老人坐老下来	老人坐了下来
传闻不是正确的	传闻不是正确的
出租车到老	出租车到了
风停老	风停了
莫得任何肥皂	没有任何肥皂
那有两块蛋糕	那有两块蛋糕
有车来老	有车来了
莫得再多的盐老	没有再多的盐了
这些鞋是她的	这些鞋是她的
他们是我的兄弟	他们是我的兄弟
他们不喜欢你	他们不喜欢你
他们考试失败老	他们考试失败了
他们继续走	他们继续走
他们彼此相爱	他们彼此相爱
他们让我当老队长	他们让我当了队长
他们切老鸟取	他们去了鸟取
他们两个都喝醉老	他们两个都喝醉了
他们被吓到老	他们被吓到了
他们受到迫害	他们受到迫害
他们害怕我们	他们害怕我们
他们已经在这里老	他们已经在这里了
他们都是艺术家	他们都是艺术家
这辆自行车是我的	这辆自行车是我的
这是一部好电影	这是一部好电影
这是个小镇	这是个小镇
这是只给你的	这是只给你的
这个工作莫得酬劳	这个工作没有酬劳
这份工作不付钱的	这份工作不付钱的
这肯定是我的书	这肯定是我的书
这本小说很无聊	这本小说很无聊
这茶味道不错	这茶味道不错
那些苹果很大	那些苹果很大
今天是我的生日	今天是我的生日
汤姆打破老窗户	汤姆打破了窗户
汤姆泪流满面	汤姆泪流满面
汤姆不吃猪肉	汤姆不吃猪肉
汤姆可不这么认为	汤姆可不这么认为
Tom喝老些果汁	Tom喝了些果汁
汤姆享受园艺	汤姆享受园艺
Tom负伤老	Tom负伤了
Tom有两个孩子	Tom有两个孩子
汤姆是个好人	汤姆是个好人
Tom是一个好人	Tom是一个好人
汤姆是个好工人	汤姆是个好工人
汤姆总是旷课	汤姆总是旷课
Tom在洗澡	Tom在洗澡
汤姆是必不可少的	汤姆是必不可少的
汤姆真有才华	汤姆真有才华
我看见的是汤姆	我看见的是汤姆
汤姆己经在那里老	汤姆己经在那里了
汤姆多才多艺	汤姆多才多艺
汤姆让玛丽回家	汤姆让玛丽回家
汤姆看来有点不适	汤姆看来有点不适
汤姆喜欢做这事	汤姆喜欢做这事
汤姆擦老地板	汤姆擦了地板
汤姆需要接受治疗	汤姆需要接受治疗
汤姆说玛丽害羞	汤姆说玛丽害羞
汤姆说他爱我	汤姆说他爱我
汤姆说他病老	汤姆说他病了
汤姆看老展览会	汤姆看了展览会
汤姆睡到中午	汤姆睡到中午
汤姆还是不能读书	汤姆还是不能读书
汤姆一定很能讲	汤姆一定很能讲
汤姆教老我法语	汤姆教了我法语
汤姆企图刺我	汤姆企图刺我
汤姆把电视调大声	汤姆把电视调大声
汤姆想见我	汤姆想见我
汤姆是建筑师	汤姆是建筑师
汤姆过切很保守	汤姆过去很保守
汤姆不会喜欢它	汤姆不会喜欢它
海龟是爬行动物	海龟是爬行动物
我们不能光坐着	我们不能光坐着
我们交老朋友	我们交了朋友
我们有两个孩子	我们有两个孩子
我们莫得失切太多	我们没有失去太多
我们一开始就知道	我们一开始就知道
我们在教堂里遇到	我们在教堂里遇到
我们必须做点甚么	我们必须做点甚么
我们必须切学校老	我们必须去学校了
我们追着猫	我们追着猫
我们跑下山	我们跑下山
我们需要你的帮助	我们需要你的帮助
我们卖柳橙汁	我们卖柳橙汁
我们拐错弯老	我们拐错弯了
我们试着阻止你	我们试着阻止你
我们切看老比赛	我们去看了比赛
我们要乘火车切	我们要乘火车去
我们正在切市里	我们正在去市里
我们准备离开	我们准备离开
我们很不一样	我们很不一样
多么荒唐的故事	多么荒唐的故事
你在煮啥子	你在煮什么
你在写啥子	你在写什么
您现在想要啥子	您现在想要什么
你现在想要啥子	你现在想要什么
它包含老啥子	它包含了什么
他发生老啥子事	他发生了什么事
我们需要的是帮助	我们需要的是帮助
你会给汤姆啥子	你会给汤姆什么
橱柜里有啥子	橱柜里有什么
啥子是不必要的	什么是不必要的
每天费用多少	每天费用多少
你的昵称是甚么	你的昵称是甚么
啥子时候开始	什么时候开始
是啥子时候完成的	是什么时候完成的
你啥子时候要出切	你什么时候要出去
我们在哪里见面	我们在哪里见面
我的伞在哪	我的伞在哪
邮箱在哪里	邮箱在哪里
哪里有问题	哪里有问题
厕所在哪里	厕所在哪里
哪一本书比较好	哪一本书比较好
哪个能做这件工作	谁能做这件工作
你和哪个住在一起	你和谁住在一起
哪个还在这里	谁还在这里
哪个给老你这些东西	谁给了你这些东西
玻璃是哪个发明的	玻璃是谁发明的
哪个邀请老你们	谁邀请了你们
哪个是秘书	谁是秘书
哪个写老这个故事	谁写了这个故事
我们何不回家呢	我们何不回家呢
你为甚么不抱我	你为甚么不抱我
今晚会下雪吗	今晚会下雪吗
你想切吗	你想去吗
你一直努力工作	你一直努力工作
你是不可抗拒的	你是不可抗拒的
您不是个懦夫	您不是个懦夫
你不是个懦夫	你不是个懦夫
你现在是大人老	你现在是大人了
你可以相信那个	你可以相信那个
你可以寄希望于此	你可以寄希望于此
你可以跟我来	你可以跟我来
你可以相信她	你可以相信她
你能握我的手	你能握我的手
你可以使用这辆车	你可以使用这辆车
你不能到外面切	你不能到外面去
你不配	你不配
你不需要枪	你不需要枪
你不需要钱	你不需要钱
你看起来不高兴	你看起来不高兴
你不老解	你不了解
你欠我点东西	你欠我点东西
你应该道歉	你应该道歉
你该知道这个	你该知道这个
你不应该出切	你不应该出去
你最好回家	你最好回家
你开车很好	你开车很好
你是个好的领导人	你是个好的领导人
你是个真正的朋友	你是个真正的朋友
你注定失败	你注定失败
你就是胆小鬼	你就是胆小鬼
你真是个傻瓜	你真是个傻瓜
你被骗老	你被骗了
你进步老	你进步了
你的回答是错的	你的回答是错的
您的狗非常胖	您的狗非常胖
你的狗非常胖	你的狗非常胖
你的观点是重要的	你的观点是重要的
海豚是哺乳动物	海豚是哺乳动物
尤其是要有耐心	尤其是要有耐心
实际上我错老	实际上我错了
律师都是骗子	律师都是骗子
任何小孩都能做到	任何小孩都能做到
这些是你的东西吗	这些是你的东西吗
他们都是一样的吗	他们都是一样的吗
你会怕Tom吗	你会怕Tom吗
你跟人约会吗	你跟人约会吗
你明天有空吗	你明天有空吗
你切外面吗	你去外面吗
你要唱歌吗	你要唱歌吗
你现在满意老吗	你现在满意了吗
你还在家里吗	你还在家里吗
你们还在家里吗	你们还在家里吗
你还在赢吗	你还在赢吗
你在跟我说话吗	你在跟我说话吗
要你想要的	要你想要的
熊会爬树	熊会爬树
祝你下一次好运	祝你下一次好运
小心扒手	小心扒手
你们俩都错老	你们俩都错了
我能借你的车吗	我能借你的车吗
我能吃这只橙子吗	我能吃这只橙子吗
你们会说英语吗	你们会说英语吗
查你的字典	查你的字典
你们全都过来	你们全都过来
控制就是一切	控制就是一切
他切看玛丽老吗	他去看玛丽了吗
他向你求婚老吗	他向你求婚了吗
你裁切纸张老吗	你裁切纸张了吗
你如愿以偿老吗	你如愿以偿了吗
你听到新闻老吗	你听到新闻了吗
你有关门吗	你有关门吗
你老解它吗	你了解它吗
我需要换乘吗	我需要换乘吗
他们学习英语吗	他们学习英语吗
你相信上帝吗	你相信上帝吗
你知道这首歌吗	你知道这首歌吗
你知道他是哪个吗	你知道他是谁吗
你喜欢这本书吗	你喜欢这本书吗
你常常跟他见面吗	你常常跟他见面吗
你需要这本书吗	你需要这本书吗
你真的想要吗	你真的想要吗
你说日语吗	你说日语吗
你依然爱汤姆吗	你依然爱汤姆吗
你还需要茶吗	你还需要茶吗
汤姆喝咖啡吗	汤姆喝咖啡吗
有人认识他吗	有人认识他吗
他说英语吗	他说英语吗
她有钢琴吗	她有钢琴吗
她喜欢柳橙吗	她喜欢柳橙吗
啥子都别问我	什么都别问我
不要失望	不要失望
别期盼奇迹	别期盼奇迹
别忘老我	别忘了我
不要让电视机开着	不要让电视机开着
你们别和任何人说	你们别和任何人说
别盯着别人看	别盯着别人看
别走进泥地	别走进泥地
不要碰我的相机	不要碰我的相机
别挑战我的耐心	别挑战我的耐心
别浪费时间	别浪费时间
你不打网球吗	你不打网球吗
凡人皆有得意时	凡人皆有得意时
一切都变成老黑色	一切都变成了黑色
一切都会好的	一切都会好的
毛皮大衣在打折	毛皮大衣在打折
趴在地上	趴在地上
请把它给我	请把它给我
给我你的位置	给我你的位置
回办公室切	回办公室去
祝考试好运	祝考试好运
再见祝好运	再见祝好运
他今天见他们老吗	他今天见他们了吗
我们取得进步老吗	我们取得进步了吗
你吃晚饭老吗	你吃晚饭了吗
我们以前没见过吗	我们以前没见过吗
他承认他有罪	他承认他有罪
他闯入一间房子	他闯入一间房子
他来老很多次老	他来了很多次了
他来接我走	他来接我走
他能游得很快	他能游得很快
他清老清喉咙	他清了清喉咙
他爬上老楼梯	他爬上了楼梯
他来自英格兰	他来自英格兰
他开他自己的车	他开他自己的车
他给老我1万日元	他给了我1万日元
他在德国长大	他在德国长大
他的想法是对的	他的想法是对的
他得卧床休息	他得卧床休息
他有一个大家庭	他有一个大家庭
他有很多钱	他有很多钱
他以前做过	他以前做过
他切老伦敦	他去了伦敦
他刚离开家	他刚离开家
他有三个哥哥	他有三个哥哥
他有三名兄长	他有三名兄长
他希望到国外切	他希望到国外去
他擅长驾驶	他擅长驾驶
他像他父亲	他像他父亲
他痴迷于音乐	他痴迷于音乐
他不再是个男孩	他不再是个男孩
他一定会成功	他一定会成功
他正在洗他的车	他正在洗他的车
他知道他们是哪个	他知道他们是谁
他以君子之道生活	他以君子之道生活
他可能会不高兴	他可能会不高兴
他休息老一会儿	他休息了一会儿
他说他不会来	他说他不会来
他讲不好法语	他讲不好法语
他出生在非洲	他出生在非洲
他在一家工厂工作	他在一家工厂工作
他害怕蛇	他害怕蛇
他怕蛇	他怕蛇
他是我的哥哥	他是我的哥哥
他比汤姆矮	他比汤姆矮
他的演唱会很棒	他的演唱会很棒
他的计划是危险的	他的计划是危险的
你啷个敢那么说	你怎么敢那么说
你啷个到那的	你怎么到那的
你觉得日本啷个样	你觉得日本怎么样
你啷个做箱子	你怎么做箱子
您能跳多高	您能跳多高
你能跳多高	你能跳多高
你待老多久	你待了多久
要花多久时间	要花多久时间
他要多少	他要多少
我欠您多少	我欠您多少
还剩多少时间	还剩多少时间
这要多少钱	这要多少钱
面试啷个样	面试怎么样
我佩服你的勇气	我佩服你的勇气
我现在30岁老	我现在30岁了
我在叠我的连衣裙	我在叠我的连衣裙
我在车站附近	我在车站附近
我在打棒球	我在打棒球
我不擅长游泳	我不擅长游泳
我比你矮	我比你矮
我厌倦老我的工作	我厌倦了我的工作
我厌倦老阅读	我厌倦了阅读
我读书读腻老	我读书读腻了
我非常非常抱歉	我非常非常抱歉
我正在写一封信	我正在写一封信
我打赌他会生气	我打赌他会生气
我上周买老它	我上周买了它
我可以自己做	我可以自己做
我可以在一周内做	我可以在一周内做
我可以打开这扇窗	我可以打开这扇窗
我找不到我的鞋子	我找不到我的鞋子
我选老错的那个	我选了错的那个
我不懂他的玩笑话	我不懂他的玩笑话
我啥子都没看见	我什么都没看见
我不喜欢独处	我不喜欢独处
我啥子都不喜欢	我什么都不喜欢
我不喜欢大狗	我不喜欢大狗
我不喜欢喝酒	我不喜欢喝酒
我不喜欢她的脸	我不喜欢她的脸
我不喜欢作业	我不喜欢作业
我不喜欢学习	我不喜欢学习
我不喜欢那家伙	我不喜欢那家伙
我不喜欢这个	我不喜欢这个
我不需要任何东西	我不需要任何东西
我啥子都不需要	我什么都不需要
我不想要老	我不想要了
我跳进老河里	我跳进了河里
我甚至让汤姆笑老	我甚至让汤姆笑了
我终于找到工作老	我终于找到工作了
我给我妈老	我给我妈了
我的感冒传染老他	我的感冒传染了他
我十一点上床	我十一点上床
我乘车切学校	我乘车去学校
我没啥子可隐藏	我没什么可隐藏
我得留在家里	我得留在家里
我头疼得厉害	我头疼得厉害
我明天有课	我明天有课
我有八个兄弟姐妹	我有八个兄弟姐妹
我掉老我的钱包	我掉了我的钱包
我有很多才能	我有很多才能
我没啥子可说的	我没什么可说的
我必须要减肥老	我必须要减肥了
我得叫醒汤姆	我得叫醒汤姆
我还没决定	我还没决定
我藏在桌子底下	我藏在桌子底下
我今天雇老个人	我今天雇了个人
我解决不老老	我解决不了了
我知道我的限度	我知道我的限度
我知道我在做啥子	我知道我在做什么
我见过你的女朋友	我见过你的女朋友
我现在必须离开	我现在必须离开
我必须帮忙我母亲	我必须帮忙我母亲
我必须偿还债务	我必须偿还债务
我欠你10美元	我欠你10美元
我和他比赛跑步	我和他比赛跑步
我赶快跑走老	我赶快跑走了
我真的很想要它	我真的很想要它
我真喜欢阅读	我真喜欢阅读
我记得我看过她	我记得我看过她
我记得见过他	我记得见过他
我尊敬长辈	我尊敬长辈
我每天早上刮胡子	我每天早上刮胡子
我签老文件	我签了文件
我认为汤姆不会赢	我认为汤姆不会赢
我认为他不会来	我认为他不会来
我认为你傻	我认为你傻
我以为这是真的	我以为这是真的
我告诉过你出切	我告诉过你出去
我转动老门把	我转动了门把
我以前打网球	我以前打网球
我想变有钱	我想变有钱
我要切义大利	我要去义大利
我想和你一起切	我想和你一起去
我想和你一起走	我想和你一起走
我想继续走	我想继续走
我想离开巴黎	我想离开巴黎
我想减肥	我想减肥
我想早点退休	我想早点退休
我要切看电影	我要去看电影
我想唱个歌	我想唱个歌
我要洗澡	我要洗澡
我想跟他说话	我想跟他说话
我想访问韩国	我想访问韩国
我希望你能长大	我希望你能长大
我想过扇你一巴掌	我想过扇你一巴掌
我当时在卫生间	我当时在卫生间
我真是满意	我真是满意
我刚切过那里	我刚去过那里
但愿我见过她	但愿我见过她
但愿我年轻一点	但愿我年轻一点
我不想再做这个老	我不想再做这个了
我不需要任何帮助	我不需要任何帮助
我不会再见她	我不会再见她
我想知道哪个来老	我想知道谁来了
我喜欢切滑雪	我喜欢去滑雪
我明天回来	我明天回来
我明天会很忙	我明天会很忙
我会立刻到那里	我会立刻到那里
我会让汤姆告诉你	我会让汤姆告诉你
我会非常想念你	我会非常想念你
我会为你带路	我会为你带路
我有一点困惑老	我有一点困惑了
我真是欣喜若狂	我真是欣喜若狂
我恐高	我恐高
我怕蜘蛛	我怕蜘蛛
我几乎能确定	我几乎能确定
我正在做我的作业	我正在做我的作业
我要切银行老	我要去银行了
我切公园	我去公园
我对那事很是感激	我对那事很是感激
我在玩电视游乐器	我在玩电视游乐器
我还是你的朋友	我还是你的朋友
我在休假	我在休假
我睡得很好	我睡得很好
我钱已经用完老	我钱已经用完了
汤姆准备好老吗	汤姆准备好了吗
包括早饭吗	包括早饭吗
他怕死吗	他怕死吗
它在你家附近吗	它在你家附近吗
真的是可能的吗	真的是可能的吗
这真的值得吗	这真的值得吗
火星上有生命吗	火星上有生命吗
这是你的女儿吗	这是你的女儿吗
它让我感觉很好	它让我感觉很好
这可能是一场婚礼	这可能是一场婚礼
似乎很便宜	似乎很便宜
它的滋味真的很好	它的滋味真的很好
这是糟糕的一天	这是糟糕的一天
这出乎意料地容易	这出乎意料地容易
它真特别	它真特别
绝对将要下雨	绝对将要下雨
你不吃没关系	你不吃没关系
我的生日就快到老	我的生日就快到了
巴黎在下雪	巴黎在下雪
现在真是不一样老	现在真是不一样了
把下周日空出来	把下周日空出来
别碰我的相机	别碰我的相机
让我们切海边吧	让我们去海边吧
有其父必有其子	有其父必有其子
看这是我的问题	看这是我的问题
就当在家一样	就当在家一样
可能我就是个傻子	可能我就是个傻子
你可能该动一动	你可能该动一动
我的孩子是双胞胎	我的孩子是双胞胎
我父亲是个大夫	我父亲是个大夫
我父亲喜欢批萨	我父亲喜欢批萨
我父亲爱吃比萨	我父亲爱吃比萨
我的右手麻老	我的右手麻了
我的房间就在楼下	我的房间就在楼下
我的房间非常小	我的房间非常小
我的房间很小	我的房间很小
我妹妹经常哭	我妹妹经常哭
我的内裤是湿的	我的内裤是湿的
我的内衣脏老	我的内衣脏了
莫得人听我的	没有人听我的
莫得人在阻止你	没有人在阻止你
不我没写	不我没写
莫得人理解我	没有人理解我
这不是你的事	这不是你的事
打网球很有趣	打网球很有趣
请关门	请关门
请不要这样说	请不要这样说
请你不要说这个	请你不要说这个
请切银行	请去银行
请保守秘密	请保守秘密
请让我静一静	请让我静一静
请带我到处看看	请带我到处看看
请坐	请坐
请你考虑考虑	请你考虑考虑
把你的自行车放好	把你的自行车放好
放下你们的武器	放下你们的武器
红色不流行老	红色不流行了
重新启动你的电脑	重新启动你的电脑
换种方式说	换种方式说
她收下老他的礼物	她收下了他的礼物
她几乎喝晕老	她几乎喝晕了
她很伤心地回答	她很伤心地回答
她向我求助	她向我求助
她会打鼓	她会打鼓
她决定辞职老	她决定辞职了
她给老我一件礼物	她给了我一件礼物
她切过巴黎	她去过巴黎
她恨她的丈夫	她恨她的丈夫
她用力地拍老球	她用力地拍了球
她跟你一样高	她跟你一样高
她明显生病老	她明显生病了
她不是一个好厨师	她不是一个好厨师
她现在不在家	她现在不在家
她住在纽约	她住在纽约
她使他长大成人	她使他长大成人
她好像很讨厌你	她好像很讨厌你
她说话幼稚	她说话幼稚
她教我们法语	她教我们法语
她八十一岁老	她八十一岁了
她穿着舞鞋	她穿着舞鞋
她给花园除老草	她给花园除了草
她是个倔强的女孩	她是个倔强的女孩
她正吃着一个苹果	她正吃着一个苹果
她在上厕所	她在上厕所
她是我的姐姐	她是我的姐姐
禁止吸烟	禁止吸烟
有人被谋杀老	有人被谋杀了
有人来过这里	有人来过这里
有人救老我的命	有人救了我的命
有些东西在变化	有些东西在变化
请别再发誓老	请别再发誓了
她热泪盈眶	她热泪盈眶
告诉我你要啥子	告诉我你要什么
谢谢你给我打电话	谢谢你给我打电话
谢谢你的答复	谢谢你的答复
那本书很旧	那本书很旧
那本书在这里	那本书在这里
那辆车十分新	那辆车十分新
那对我莫得用处	那对我没有用处
那看起来像血	那看起来像血
那不太好	那不太好
很棒不是吗	很棒不是吗
那太好老不是吗	那太好了不是吗
宝宝对我笑老	宝宝对我笑了
男孩到家老	男孩到家了
男孩赤裸着上身	男孩赤裸着上身
面包不新鲜	面包不新鲜
蛋糕很美味	蛋糕很美味
那孩子要六岁老	那孩子要六岁了
时钟已经停止老	时钟已经停止了
门咔哒一声关上老	门咔哒一声关上了
火已经灭老	火已经灭了
女孩们睡着老	女孩们睡着了
这肉已经坏老	这肉已经坏了
计划被执行老	计划被执行了
问题不是汤姆	问题不是汤姆
风险太大	风险太大
这班火车已经到老	这班火车已经到了
战争还没结束	战争还没结束
莫得问题	没有问题
莫得办法赢	没有办法赢
这些箱子是重的	这些箱子是重的
他们突然哭老	他们突然哭了
他们取笑玛丽	他们取笑玛丽
他们从不说谎	他们从不说谎
他们应该会被吓到	他们应该会被吓到
他们嚐老面包	他们嚐了面包
他们洗手	他们洗手
他们工作的很辛苦	他们工作的很辛苦
他们正在吃苹果	他们正在吃苹果
这只狗是杂种狗	这只狗是杂种狗
这就是我的办法	这就是我的办法
这是我的字典	这是我的字典
这是我的第一次	这是我的第一次
这不是真实的爱情	这不是真实的爱情
这要花时间	这要花时间
这只梨闻上切很香	这只梨闻上去很香
那些都是我的裤子	那些都是我的裤子
这是他们的书	这是他们的书
时间不等人	时间不等人
汤姆和我是朋友	汤姆和我是朋友
汤姆当上老部长	汤姆当上了部长
汤姆买老新手套	汤姆买了新手套
汤姆烧掉老信	汤姆烧掉了信
汤姆叫老警察	汤姆叫了警察
汤姆会保密	汤姆会保密
汤姆负担不起	汤姆负担不起
汤姆不能开巴士	汤姆不能开巴士
汤姆说话不多	汤姆说话不多
汤姆不在这里工作	汤姆不在这里工作
汤姆准备睡觉	汤姆准备睡觉
汤姆不得不自己切	汤姆不得不自己去
汤姆有好的记忆力	汤姆有好的记忆力
汤姆有预约	汤姆有预约
汤姆变胖老	汤姆变胖了
汤姆失切理智老	汤姆失去理智了
汤姆写给我老	汤姆写给我了
汤姆在安慰玛丽	汤姆在安慰玛丽
Tom正在喝果汁	Tom正在喝果汁
汤姆对我友好	汤姆对我友好
Tom是我爷爷	Tom是我爷爷
汤姆是我想要的人	汤姆是我想要的人
汤姆现在很生气	汤姆现在很生气
汤姆戴着手套	汤姆戴着手套
Tom最喜欢我	Tom最喜欢我
Tom应该要担心	Tom应该要担心
汤姆暗中笑玛丽	汤姆暗中笑玛丽
汤姆想坐下	汤姆想坐下
汤姆怕你	汤姆怕你
汤姆在周一被埋老	汤姆在周一被埋了
汤姆准备切工作	汤姆准备去工作
汤姆惊恐地盯着	汤姆惊恐地盯着
汤姆的教练喜欢他	汤姆的教练喜欢他
二乘以二等于四	二乘以二等于四
在这儿等一会儿	在这儿等一会儿
我们都希望和平	我们都希望和平
我们战胜老敌人	我们战胜了敌人
我们尽我们所能	我们尽我们所能
我们喝老很多	我们喝了很多
我们有多馀的时间	我们有多馀的时间
我们有两个女儿	我们有两个女儿
我们用耳朵听	我们用耳朵听
我们只想赢	我们只想赢
我们欠你个道歉	我们欠你个道歉
我们缺钱老	我们缺钱了
我们应该做到最好	我们应该做到最好
我们轮流开车	我们轮流开车
我们每天看电视	我们每天看电视
我们立即开始施工	我们立即开始施工
我们还得回切	我们还得回去
我们在等汤姆	我们在等汤姆
我们有情况老	我们有情况了
你们是认真的吗	你们是认真的吗
你发现老甚么	你发现了甚么
我们必须做甚么	我们必须做甚么
汤姆建议老啥子	汤姆建议了什么
我的房间号是多少	我的房间号是多少
你到底啷个回事啊	你到底怎么回事啊
你是啥子时候来的	你是什么时候来的
你啥子时候睡觉	你什么时候睡觉
他们何时抵达	他们何时抵达
你啥子时候有空	你什么时候有空
浴室在哪里	浴室在哪里
你的东西在哪里	你的东西在哪里
你们的东西在哪里	你们的东西在哪里
您的东西在哪里	您的东西在哪里
你在哪儿看到老她	你在哪儿看到了她
你现在住在哪里	你现在住在哪里
你现在在哪里工作	你现在在哪里工作
我的报纸在哪里	我的报纸在哪里
洗手间在哪里	洗手间在哪里
错在哪里	错在哪里
你把我当啥子啦	你把我当什么啦
你女朋友是哪个	你女朋友是谁
你为啥子问我	你为什么问我
你为啥子来这里	你为什么来这里
你为啥子不回家呢	你为什么不回家呢
你为啥子长不大呢	你为什么长不大呢
为啥子改变那么难	为什么改变那么难
明天会下雨吗	明天会下雨吗
你会待在家吗	你会待在家吗
你想切旅游吗	你想去旅游吗
把所有东西写下来	把所有东西写下来
把你的目标写下来	把你的目标写下来
你是一个好人	你是一个好人
您是一个好人	您是一个好人
你莫得保护我	你没有保护我
你不必吃	你不必吃
你必须做到最好	你必须做到最好
你必须停止吸烟	你必须停止吸烟
你需要做好准备	你需要做好准备
你需要寻求协助	你需要寻求协助
种啥子因得啥子果	种什么因得什么果
你应该做笔记	你应该做笔记
你那时不在这里	你那时不在这里
你会习惯的	你会习惯的
你这个吝啬的老头	你这个吝啬的老头
你在吓我	你在吓我
你们有大麻烦老	你们有大麻烦了
你真没用	你真没用
你必须醒醒	你必须醒醒
零在一前面	零在一前面
我有一个好主意	我有一个好主意
海绵吸水	海绵吸水
所有狗都活着	所有狗都活着
他们都像这一样吗	他们都像这一样吗
你怕虫子吗	你怕虫子吗
你跟人约会过吗	你跟人约会过吗
你现在有空吗	你现在有空吗
你是在对我说吗	你是在对我说吗
小心别摔倒老	小心别摔倒了
你和我都是男人	你和我都是男人
哪个会相信你	谁会相信你
我们能私下谈谈吗	我们能私下谈谈吗
你会记帐吗	你会记帐吗
能请你离开吗	能请你离开吗
你会弹钢琴吗	你会弹钢琴吗
你可以闭嘴吗	你可以闭嘴吗
我们做不成吗	我们做不成吗
猫不吃香蕉	猫不吃香蕉
过来和我跳舞啊	过来和我跳舞啊
把帐单给我好吗	把帐单给我好吗
你能来这里吗	你能来这里吗
死人不会告密	死人不会告密
他们有买果汁吗	他们有买果汁吗
你听到老点击声吗	你听到了点击声吗
你看到他出切老吗	你看到他出去了吗
你看老比赛吗	你看了比赛吗
你没看见那个人吗	你没看见那个人吗
你知道答案吗	你知道答案吗
你喜欢黑色的猫吗	你喜欢黑色的猫吗
你每天都学习吗	你每天都学习吗
你们每天都读书吗	你们每天都读书吗
您每天都读书吗	您每天都读书吗
你认为我疯老吗	你认为我疯了吗
你想致富吗	你想致富吗
你想进来吗	你想进来吗
您想听它吗	您想听它吗
她会说英语吗	她会说英语吗
不要问我要钱	不要问我要钱
我不在就别开始	我不在就别开始
不要改变你的心意	不要改变你的心意
别在这儿扔垃圾	别在这儿扔垃圾
别低估我	别低估我
别为此担心	别为此担心
别用红墨水写	别用红墨水写
你不用工作吗	你不用工作吗
每个人都很困惑	每个人都很困惑
所有人都很吃惊	所有人都很吃惊
一切都在变	一切都在变
系上你们的安全带	系上你们的安全带
狐狸是野生动物	狐狸是野生动物
冷静下来	冷静下来
给我一点钱	给我一点钱
也给我一些牛奶	也给我一些牛奶
给猫喂点肉	给猫喂点肉
您见过这个人吗	您见过这个人吗
他问老我一个问题	他问了我一个问题
他只是哭	他只是哭
他根本就莫得学习	他根本就没有学习
他死于肺癌	他死于肺癌
他不喜欢喝咖啡	他不喜欢喝咖啡
他的胃口很好	他的胃口很好
他已经切老英国	他已经去了英国
他擅长足球	他擅长足球
他敲老门	他敲了门
他常引用米尔顿	他常引用米尔顿
他装听不见	他装听不见
他可能不会来老	他可能不会来了
他从中国回来老	他从中国回来了
他跑得跟你一样快	他跑得跟你一样快
他唱老些老歌	他唱了些老歌
他看到她就脸红老	他看到她就脸红了
他精神很好	他精神很好
他切看牙医老	他去看牙医了
他出切散步	他出去散步
他比你强壮	他比你强壮
他真是甜心	他真是甜心
健康比财富重要	健康比财富重要
帮助我们达成目标	帮助我们达成目标
她父亲是日本人	她父亲是日本人
这里有一些图片	这里有一些图片
他的车真的很酷	他的车真的很酷
他父亲是日本人	他父亲是日本人
他的计划被驳回老	他的计划被驳回了
他的话给老我希望	他的话给了我希望
他的话让我吃惊	他的话让我吃惊
希望不是一种策略	希望不是一种策略
那持续老多久老	那持续了多久了
要多长时间	要多长时间
我总是信守承诺	我总是信守承诺
我与他联系	我与他联系
我下个星期离开	我下个星期离开
我16岁老	我16岁了
我厌倦老功课	我厌倦了功课
我请他帮我	我请他帮我
我匆忙地吃老午饭	我匆忙地吃了午饭
我相信汤姆是对的	我相信汤姆是对的
我给她买老辆新车	我给她买了辆新车
我遇到老故障	我遇到了故障
我不能让那事发生	我不能让那事发生
我能跟任何人工作	我能跟任何人工作
我现在不能回答你	我现在不能回答你
我现在不能解释	我现在不能解释
我不老解他	我不了解他
我找不到我的票	我找不到我的票
我听不太清楚	我听不太清楚
我无法忍受它老	我无法忍受它了
我敢说他是对的	我敢说他是对的
我决定买一辆车	我决定买一辆车
我发现老真相	我发现了真相
我不同意他	我不同意他
我莫得夥伴	我没有夥伴
我时间不多	我时间不多
我现在不知道	我现在不知道
我不知道他是哪个	我不知道他是谁
我不喜欢这个主意	我不喜欢这个主意
我不需要你的帮助	我不需要你的帮助
我唱歌不太好	我唱歌不太好
我不在床上睡觉	我不在床上睡觉
我不说日语	我不说日语
我不像那样工作	我不像那样工作
我喝老一杯水	我喝了一杯水
我羨慕他的新房子	我羨慕他的新房子
我很早就切睡觉	我很早就去睡觉
我每天切上班	我每天去上班
我上错车老	我上错车了
我玩得很愉快	我玩得很愉快
我的钱包被偷老	我的钱包被偷了
我必须切美国	我必须去美国
我牙痛得厉害	我牙痛得厉害
我有一双鞋	我有一双鞋
我听说过那个故事	我听说过那个故事
今天我莫得精神	今天我没有精神
我听到门关老	我听到门关了
昨天我帮老他	昨天我帮了他
我打老他的肚子	我打了他的肚子
我希望汤姆不生气	我希望汤姆不生气
我就是不能说不	我就是不能说不
我知道他会接受的	我知道他会接受的
我知道我欠你钱	我知道我欠你钱
我知道你多大老	我知道你多大了
我知道你们都是哪个	我知道你们都是谁
我把它留在桌上老	我把它留在桌上了
我非常喜欢比萨	我非常喜欢比萨
我最喜欢夏天	我最喜欢夏天
我也喜欢这个颜色	我也喜欢这个颜色
我喜欢独自旅行	我喜欢独自旅行
我非常喜欢匹萨	我非常喜欢匹萨
我爱这里的人们	我爱这里的人们
我在俱乐部见到他	我在俱乐部见到他
我可能犯老个错	我可能犯了个错
我喜欢茶胜过咖啡	我喜欢茶胜过咖啡
我把它放在抽屉里	我把它放在抽屉里
我看见他洗车	我看见他洗车
我好像发烧老	我好像发烧了
我在网路上卖衣服	我在网路上卖衣服
我只睡老两小时	我只睡了两小时
我祇睡老两小时	我祇睡了两小时
我猜想您喜欢他	我猜想您喜欢他
我觉得汤姆有外遇	我觉得汤姆有外遇
我经常想着它	我经常想着它
我认为这是真的	我认为这是真的
我觉得你妒忌老	我觉得你妒忌了
我完全明白	我完全明白
我要一夸脱的牛奶	我要一夸脱的牛奶
我要一些甜的东西	我要一些甜的东西
我想骑马	我想骑马
我很高兴见到他	我很高兴见到他
我不是在骂你	我不是在骂你
我完全不懂老	我完全不懂了
我真是惊讶	我真是惊讶
我昨天切那儿老	我昨天去那儿了
昨天我切老那里	昨天我去了那里
我会很乐意帮助你	我会很乐意帮助你
下次我不做老	下次我不做了
我希望切夏威夷	我希望去夏威夷
我希望你慢下来	我希望你慢下来
这周我一直在工作	这周我一直在工作
我的牛排要生的	我的牛排要生的
我想看看它	我想看看它
我想租一辆车	我想租一辆车
我更愿意跟着你	我更愿意跟着你
我宁愿切游泳	我宁愿去游泳
我马上就来	我马上就来
我会再喝一杯啤酒	我会再喝一杯啤酒
我会留给你	我会留给你
我会想念你的厨艺	我会想念你的厨艺
我会研究你的报告	我会研究你的报告
我明天告诉汤姆	我明天告诉汤姆
我会等一两天	我会等一两天
我害怕一个人切	我害怕一个人去
我渴望见到你	我渴望见到你
我现在在机场	我现在在机场
我今天的心情不好	我今天的心情不好
我很高兴你回来老	我很高兴你回来了
我要失切它老	我要失去它了
我来协助你	我来协助你
我正在听音乐	我正在听音乐
我在找我的钢笔	我在找我的钢笔
我莫得你高	我没有你高
我没跟汤姆结婚	我没跟汤姆结婚
我正考虑到你	我正考虑到你
我突然想到你	我突然想到你
我在翻译一本书	我在翻译一本书
我一直聪明	我一直聪明
我得老重感冒	我得了重感冒
我有一些朋友	我有一些朋友
铁是个有用的金属	铁是个有用的金属
铁是种有用的金属	铁是种有用的金属
今天有人缺席吗	今天有人缺席吗
他还有兴趣吗	他还有兴趣吗
那是一张近照吗	那是一张近照吗
是我说的吗	是我说的吗
还有多馀的盐吗	还有多馀的盐吗
这个位子空着吗	这个位子空着吗
那不够好吗	那不够好吗
这并不让我惊讶	这并不让我惊讶
是我错老	是我错了
看起来像个苹果	看起来像个苹果
不太可能	不太可能
它花老我三年	它花了我三年
这太可怕老	这太可怕了
我要花很长时间	我要花很长时间
今天非常热	今天非常热
今天早上冷	今天早上冷
今天相当暖和	今天相当暖和
这由你来决定	这由你来决定
午餐时间到老	午餐时间到了
我是为你来的	我是为你来的
让窗子关着	让窗子关着
既往不咎	既往不咎
让我来切胡萝卜	让我来切胡萝卜
让我试试别的	让我试试别的
让他们向我们学习	让他们向我们学习
咱们切吃饭吧	咱们去吃饭吧
我们切看电影吧	我们去看电影吧
让我们切野餐	让我们去野餐
我们坐在草地上吧	我们坐在草地上吧
我们立刻开始吧	我们立刻开始吧
躺在你右边	躺在你右边
我可以切厕所吗	我可以去厕所吗
我可以自我介绍吗	我可以自我介绍吗
我现在能睁眼吗	我现在能睁眼吗
管好你自己的事吧	管好你自己的事吧
我的电视已经坏老	我的电视已经坏了
我的猫会爱上这个	我的猫会爱上这个
我的胆固醇很高	我的胆固醇很高
我父亲切钓鱼老	我父亲去钓鱼了
我爸会杀老我的	我爸会杀了我的
我的头皮非常痒	我的头皮非常痒
我儿子不听我话	我儿子不听我话
除老汤姆莫得人来	除了汤姆没有人来
没人管束或开导他	没人管束或开导他
莫得人知道真相	没有人知道真相
请睁开眼睛	请睁开眼睛
请确认帐单	请确认帐单
请小心驾驶	请小心驾驶
饶老我吧	饶了我吧
请关灯	请关灯
请打开瓶子	请打开瓶子
请拼一哈您的名字	请拼一下您的名字
请关闭电视机	请关闭电视机
请快点回信	请快点回信
承诺是不够的	承诺是不够的
把你的丝袜拉上切	把你的丝袜拉上去
穿上你的好鞋	穿上你的好鞋
不要说话好不好	不要说话好不好
卖车是我的工作	卖车是我的工作
我应该把门关上吗	我应该把门关上吗
她一直都相信我	她一直都相信我
她向他求助	她向他求助
她咬老一口苹果	她咬了一口苹果
她进老房间	她进了房间
她常常感冒	她常常感冒
她不喜欢寿司	她不喜欢寿司
她给他一件毛衣	她给他一件毛衣
她从车里出来老	她从车里出来了
她下老车	她下了车
她有一点钱	她有一点钱
她递给老他钥匙	她递给了他钥匙
她有点儿面包	她有点儿面包
她很喜欢动物	她很喜欢动物
她看上切十分优雅	她看上去十分优雅
她特别想切	她特别想去
她长得像她姑姑	她长得像她姑姑
她切年出生	她去年出生
她自己起床的	她自己起床的
她已经睡下老	她已经睡下了
她的确是正确的	她的确是正确的
她比他年轻	她比他年轻
我该上大学吗	我该上大学吗
请为我们唱首歌吧	请为我们唱首歌吧
那如果那是真的呢	那如果那是真的呢
有人在叫你	有人在叫你
体育无国界	体育无国界
别进我的厨房	别进我的厨房
你喜欢啥子就拿吧	你喜欢什么就拿吧
告诉我汤姆的情况	告诉我汤姆的情况
告诉我你想要哪个	告诉我你想要哪个
同样感谢你	同样感谢你
谢谢提供新消息	谢谢提供新消息
谢谢你的建议	谢谢你的建议
那可能太晚老	那可能太晚了
那真是无聊	那真是无聊
那真不公平	那真不公平
那从不会发生	那从不会发生
那会有关系	那会有关系
那不太可能	那不太可能
这是我的最终回答	这是我的最终回答
这是我唯一关心的	这是我唯一关心的
那不是汤姆的错	那不是汤姆的错
那真奇怪不是么	那真奇怪不是么
正午时分钟声响起	正午时分钟声响起
乘公交车费时	乘公交车费时
这个女孩莫得母亲	这个女孩没有母亲
这刀不锋利	这刀不锋利
法律很清楚	法律很清楚
下一个给你	下一个给你
疼痛令人难以忍受	疼痛令人难以忍受
笔在桌上	笔在桌上
雨变小老	雨变小了
后门曾开着	后门曾开着
积雪深及膝盖	积雪深及膝盖
花瓶被打碎老	花瓶被打碎了
今天刮冷风	今天刮冷风
女人瞪老我们	女人瞪了我们
那里有两座桥	那里有两座桥
莫得办法知道	没有办法知道
这些叫鞋子	这些叫鞋子
这些是一些新的	这些是一些新的
这些眼镜真酷	这些眼镜真酷
他们正在聊天	他们正在聊天
他俩想要一个孩子	他俩想要一个孩子
他们闭上眼睛	他们闭上眼睛
他们有时帮我们	他们有时帮我们
他们谈论老爱情	他们谈论了爱情
他们非常兴奋	他们非常兴奋
他们正在挖一个洞	他们正在挖一个洞
这只苹果非常红	这只苹果非常红
这是最终决定	这是最终决定
这是汤姆的雨伞	这是汤姆的雨伞
这是张木桌	这是张木桌
这不是一句话	这不是一句话
这不是一个句子	这不是一个句子
这是真实的世界	这是真实的世界
这是非常昂贵的	这是非常昂贵的
这是非常好的土壤	这是非常好的土壤
这不是好主意	这不是好主意
这让我非常愤怒	这让我非常愤怒
这一个还活着	这一个还活着
这个房间太小老	这个房间太小了
这玫瑰花很美丽	这玫瑰花很美丽
这水很好喝	这水很好喝
这葡萄酒非常好喝	这葡萄酒非常好喝
汤姆向玛丽求助	汤姆向玛丽求助
汤姆向我问起你	汤姆向我问起你
汤姆不能骑马	汤姆不能骑马
汤姆捣碎老大蒜	汤姆捣碎了大蒜
汤姆莫得父亲	汤姆没有父亲
汤姆有玛丽的地址	汤姆有玛丽的地址
汤姆胃口很大	汤姆胃口很大
汤姆切过波士顿	汤姆去过波士顿
汤姆擅长烹饪	汤姆擅长烹饪
Tom在医院	Tom在医院
汤姆很胖是吧	汤姆很胖是吧
汤姆年纪比我大	汤姆年纪比我大
汤姆正在来这里	汤姆正在来这里
汤姆走神老	汤姆走神了
汤姆真会挖苦人	汤姆真会挖苦人
汤姆真帅	汤姆真帅
汤姆在说法语	汤姆在说法语
汤姆还在波士顿	汤姆还在波士顿
汤姆比你高	汤姆比你高
汤姆非常孤单	汤姆非常孤单
汤姆根本不高兴	汤姆根本不高兴
汤姆仔细听	汤姆仔细听
汤姆找他的钢笔	汤姆找他的钢笔
汤姆拿起铅笔	汤姆拿起铅笔
汤姆说他有个计划	汤姆说他有个计划
汤姆发动老引擎	汤姆发动了引擎
汤姆在哈佛学习	汤姆在哈佛学习
汤姆试着杀死玛丽	汤姆试着杀死玛丽
汤姆想见玛丽	汤姆想见玛丽
汤姆有点醉	汤姆有点醉
汤姆走下山坡	汤姆走下山坡
明天是我的休息日	明天是我的休息日
郁金香很快将盛开	郁金香很快将盛开
在楼下等我	在楼下等我
那全是幻觉吗	那全是幻觉吗
那就是汤姆说的吗	那就是汤姆说的吗
帮我看着我的相机	帮我看着我的相机
我们喜欢阅读书籍	我们喜欢阅读书籍
我们推老车	我们推了车
我们在雾中迷老路	我们在雾中迷了路
我们现在有老麻烦	我们现在有了麻烦
我们莫得电	我们没有电
我们要尽力而为	我们要尽力而为
我们必须有计画	我们必须有计画
我们互相帮忙	我们互相帮忙
我们也帮助他们	我们也帮助他们
我们喜欢踢足球	我们喜欢踢足球
我们偶然碰到老她	我们偶然碰到了她
缺一把勺子	缺一把勺子
我们需要做计划	我们需要做计划
我们还有次机会	我们还有次机会
我们会及时准备好	我们会及时准备好
我们现在就要吃饭	我们现在就要吃饭
我们是亲密的朋友	我们是亲密的朋友
我们现在缺乏库存	我们现在缺乏库存
我们依然做得很好	我们依然做得很好
我们还是脆弱不堪	我们还是脆弱不堪
我们有很多时间	我们有很多时间
多美妙的夜晚啊	多美妙的夜晚啊
那些数字是啥子	那些数字是什么
你现在在做啥子	你现在在做什么
我得老啥子病	我得了什么病
你打算啷个办	你打算怎么办
您想成为啥子	您想成为什么
你想成为啥子	你想成为什么
你想做啥子	你想做什么
你姑姑是做啥子的	你姑姑是做什么的
啥子让你这么生气	什么让你这么生气
我应该寻找啥子	我应该寻找什么
啥子时候开门	什么时候开门
她几点出生的	她几点出生的
结果会是甚么样的	结果会是甚么样的
您的职业是啥子	您的职业是什么
你几点吃的晚饭	你几点吃的晚饭
您何时需要它	您何时需要它
你啥子时候要切	你什么时候要去
它从哪里来	它从哪里来
这是你哪里拿的	这是你哪里拿的
你哪里痛	你哪里痛
自助餐厅在哪里	自助餐厅在哪里
市政府在哪里	市政府在哪里
我的苹果汁在哪	我的苹果汁在哪
电话簿在哪里	电话簿在哪里
切海滩走哪条路	去海滩走哪条路
你和哪个一起切那	你和谁一起去那
你在看哪个	你在看谁
你投给哪个	你投给谁
你把它给哪个老	你把它给谁了
哪个教你们法语	谁教你们法语
哪个告诉你这个故事	谁告诉你这个故事
你今天为啥子忙	你今天为什么忙
你为啥子需要零钱	你为什么需要零钱
你为啥子这么害怕	你为什么这么害怕
还要很久吗	还要很久吗
你要买点东西吗	你要买点东西吗
麻烦您等一哈	麻烦您等一下
麻烦您稍待一哈	麻烦您稍待一下
语言表达思想	语言表达思想
语词表达思想	语词表达思想
你想喝点啥子吗	你想喝点什么吗
你愿意来吗	你愿意来吗
你愿意等吗	你愿意等吗
是的我有学生证	是的我有学生证
你是我最好的朋友	你是我最好的朋友
你早点回来行吗	你早点回来行吗
你本来可以做的	你本来可以做的
你的成功是应得的	你的成功是应得的
你不用藏着	你不用藏着
你必须有耐心	你必须有耐心
你喜欢它不是吗	你喜欢它不是吗
你看起来就像汤姆	你看起来就像汤姆
你看着像猴	你看着像猴
你应该感谢他	你应该感谢他
你应该穿一件大衣	你应该穿一件大衣
你不该在这里吃饭	你不该在这里吃饭
你唱歌像天使	你唱歌像天使
你的英语说得很好	你的英语说得很好
你拿错钥匙老	你拿错钥匙了
你出席老我的婚礼	你出席了我的婚礼
你在偷听	你在偷听
你上班迟到老	你上班迟到了
你最好不要说	你最好不要说
你最好现在就开始	你最好现在就开始
你现在是名人老	你现在是名人了
你比玛丽可爱	你比玛丽可爱
你在进步	你在进步
你不够快	你不够快
你很健忘	你很健忘
您的蛋糕很美味	您的蛋糕很美味
你的蛋糕很美味	你的蛋糕很美味
一杯葡萄酒谢谢	一杯葡萄酒谢谢
有啥子问题吗	有什么问题吗
那两个要出切吗	那两个要出去吗
你明天要来吗	你明天要来吗
周二你有空吗	周二你有空吗
你有问题吗	你有问题吗
你是来见汤姆的吗	你是来见汤姆的吗
你在说我吗	你在说我吗
你今天晚上没空吗	你今天晚上没空吗
问我简单些的	问我简单些的
牢记他的建议	牢记他的建议
有钱还不够	有钱还不够
呼吸困难	呼吸困难
我能开拖拉机吗	我能开拖拉机吗
你能生吃牡蛎吗	你能生吃牡蛎吗
你能不能修理它	你能不能修理它
你能准时做好吗	你能准时做好吗
你会弹吉他吗	你会弹吉他吗
你真的不会游泳吗	你真的不会游泳吗
你能潜水吗	你能潜水吗
你不会说英语吗	你不会说英语吗
孩子们喜欢巧克力	孩子们喜欢巧克力
孩子们喜欢圣诞节	孩子们喜欢圣诞节
选一个你喜欢的	选一个你喜欢的
选喜欢的	选喜欢的
课程下周开始	课程下周开始
我能借支铅笔吗	我能借支铅笔吗
你能把门关上吗	你能把门关上吗
白天越来越长老	白天越来越长了
你给测验评分老吗	你给测验评分了吗
你按老按钮吗	你按了按钮吗
他们彼此相爱吗	他们彼此相爱吗
你有足够的食物吗	你有足够的食物吗
你知道我的意思吗	你知道我的意思吗
你喜欢印度菜吗	你喜欢印度菜吗
你认为我能帮忙吗	你认为我能帮忙吗
你认为我傻吗	你认为我傻吗
你想死在这里吗	你想死在这里吗
你想吃这个吗	你想吃这个吗
你想抱怨吗	你想抱怨吗
不要进入我的房间	不要进入我的房间
不要忘老票	不要忘了票
不要忘记您的钱	不要忘记您的钱
不要忘记你的钱	不要忘记你的钱
天黑以后不要出门	天黑以后不要出门
开啥子国际玩笑	开什么国际玩笑
别辞掉你的正职	别辞掉你的正职
多吃点蔬菜	多吃点蔬菜
英语是第三节	英语是第三节
每个人都有个价	每个人都有个价
每个人都想吃	每个人都想吃
跟我进房间	跟我进房间
凡事豫则立	凡事豫则立
凡事要预先准备好	凡事要预先准备好
新鲜的食物最棒老	新鲜的食物最棒了
请给我一张票	请给我一张票
把汤姆的钱还给他	把汤姆的钱还给他
给我一打橘子	给我一打橘子
给我点事做	给我点事做
载我们到市区	载我们到市区
现在出切玩吧	现在出去玩吧
离别总是让人悲伤	离别总是让人悲伤
抓住绳子	抓住绳子
你打电话给她老吗	你打电话给她了吗
你以前见过她吗	你以前见过她吗
他要老一些钱	他要了一些钱
他要求我帮助他	他要求我帮助他
他开始害怕老	他开始害怕了
他很容易感冒	他很容易感冒
他决定娶她	他决定娶她
他莫得早起	他没有早起
他三年前死老	他三年前死了
他不喜欢网球	他不喜欢网球
他不吃生鱼	他不吃生鱼
他不需要工作	他不需要工作
他喝太多啤酒	他喝太多啤酒
他终于如愿以偿老	他终于如愿以偿了
他厌倦老读书	他厌倦了读书
他下礼拜要考试	他下礼拜要考试
他曾切过北海道	他曾去过北海道
他切北海道老	他去北海道了
他对女人莫得眼光	他对女人没有眼光
他邀请我吃晚饭	他邀请我吃晚饭
他是个棒球手	他是个棒球手
他是一个友善的人	他是一个友善的人
他渴望切那里	他渴望去那里
他能说流利的中文	他能说流利的中文
他喜欢冒险	他喜欢冒险
他很难对付	他很难对付
他不擅长开车	他不擅长开车
他不是来自北海道	他不是来自北海道
他的化学很差	他的化学很差
他十分钟前离开老	他十分钟前离开了
他喜欢踢足球	他喜欢踢足球
他看起来像个医生	他看起来像个医生
他娶老一位空姐	他娶了一位空姐
他怠忽职守老	他怠忽职守了
他从不喝酒	他从不喝酒
他不再住在这里老	他不再住在这里了
他反对我们的计划	他反对我们的计划
他只有100美元	他只有100美元
他点老一杯茶	他点了一杯茶
他有时看电视	他有时看电视
他信守老承诺	他信守了承诺
他摘下老眼镜	他摘下了眼镜
他旅行洽商	他旅行洽商
他拒绝老我的提议	他拒绝了我的提议
他以前很早起床	他以前很早起床
他想找本书来读	他想找本书来读
他出生于长崎	他出生于长崎
他应该来的	他应该来的
他目睹老谋杀案	他目睹了谋杀案
他写信给他的父母	他写信给他的父母
他很快就会回家	他很快就会回家
他怕那只狗	他怕那只狗
他酷爱足球	他酷爱足球
他聪明得很	他聪明得很
他刚请假走老	他刚请假走了
他是我弟弟	他是我弟弟
再来一轮啷个样	再来一轮怎么样
休息一哈啷个样	休息一下怎么样
你今天啷个样	你今天怎么样
你是啷个进来的	你是怎么进来的
你是啷个切上学的	你是怎么去上学的
离这儿有多远	离这儿有多远
你有多爱我	你有多爱我
这个相机多少钱	这个相机多少钱
你多久后需要它	你多久后需要它
那儿是啥子天气	那儿是什么天气
那里的气候啷个样	那里的气候怎么样
我总是走路到学校	我总是走路到学校
我厌恶他	我厌恶他
我为我父亲而自豪	我为我父亲而自豪
我是跑得最快的人	我是跑得最快的人
我是最快的跑者	我是最快的跑者
我欣赏好音乐	我欣赏好音乐
我在两周前到老	我在两周前到了
我请他帮忙	我请他帮忙
我直接地问老他	我直接地问了他
我烤老苹果派	我烤了苹果派
我相信你是诚实的	我相信你是诚实的
昨天我买老这个	昨天我买了这个
我找不到我的眼镜	我找不到我的眼镜
我的眼镜不见老	我的眼镜不见了
我无法戒烟	我无法戒烟
我受不老这么热	我受不了这么热
我不弹钢琴	我不弹钢琴
我莫得电脑	我没有电脑
我没任何零钱	我没任何零钱
我不喜欢摇滚乐	我不喜欢摇滚乐
我不常见到他	我不常见到他
我不想让汤姆死	我不想让汤姆死
我再也不想要老	我再也不想要了
我不想长大	我不想长大
我喜欢拍照	我喜欢拍照
我对他期望很高	我对他期望很高
我爱上老她	我爱上了她
我收到她的来信	我收到她的来信
我梦到老他	我梦到了他
我觉得太遗憾老	我觉得太遗憾了
我刚吃过午饭	我刚吃过午饭
我没书可读	我没书可读
我必须熨我的衬衫	我必须熨我的衬衫
我得卖我的房子	我得卖我的房子
我必须吃药	我必须吃药
我做不老这个	我做不了这个
我听见一声怪响	我听见一声怪响
我从收音机听到它	我从收音机听到它
我从广播中听到它	我从广播中听到它
我听到有人进来老	我听到有人进来了
我真是不能相信	我真是不能相信
我只想高兴	我只想高兴
我只是想要你来	我只是想要你来
我知道点西班牙语	我知道点西班牙语
我知道他忙	我知道他忙
我喜欢打棒球	我喜欢打棒球
我喜欢跟汤姆唱歌	我喜欢跟汤姆唱歌
我非常喜欢网球	我非常喜欢网球
我喜欢在夜晚走路	我喜欢在夜晚走路
我爱接骨木果汁	我爱接骨木果汁
我在街上遇到他	我在街上遇到他
我明天需要知道	我明天需要知道
我需要洗个澡	我需要洗个澡
我需要你们的合作	我需要你们的合作
我只知道他的名字	我只知道他的名字
我只想忘记	我只想忘记
我啥子都欠汤姆的	我什么都欠汤姆的
我付老他五块美元	我付了他五块美元
我常打排球	我常打排球
我非常同意你	我非常同意你
我真不老解汤姆	我真不了解汤姆
我真喜欢我做的事	我真喜欢我做的事
我看见他在看我	我看见他在看我
我还有个问题	我还有个问题
我猜想您饿老	我猜想您饿了
我猜想你饿老	我猜想你饿了
我认为我快疯老	我认为我快疯了
我认为汤姆好运动	我认为汤姆好运动
我以为汤姆在睡觉	我以为汤姆在睡觉
我认为汤姆有才能	我认为汤姆有才能
我认为那不是真的	我认为那不是真的
我认为汤姆会赢	我认为汤姆会赢
我以为他会来的	我以为他会来的
我想要一颗糖	我想要一颗糖
想让他读这个	想让他读这个
我想吃苹果派	我想吃苹果派
我想摆脱它	我想摆脱它
我想切游泳	我想去游泳
我想切德国	我想去德国
我想切西雅图	我想去西雅图
我希望再次见到你	我希望再次见到你
我上周不忙	我上周不忙
我昨天不忙	我昨天不忙
我切那里很多次老	我去那里很多次了
明天我会问他的	明天我会问他的
我会永远爱你	我会永远爱你
但愿我可以帮助你	但愿我可以帮助你
我在这栋楼里工作	我在这栋楼里工作
我做那事会疯	我做那事会疯
这我要三个	这我要三个
这个给我来三个	这个给我来三个
我想跟汤姆走	我想跟汤姆走
我想用现金支付	我想用现金支付
我宁愿待在家里	我宁愿待在家里
我将参加这个会议	我将参加这个会议
我马上就回来	我马上就回来
我会来你的地方	我会来你的地方
我晚会加入你们	我晚会加入你们
我下个月会来看你	我下个月会来看你
我将拿这把伞	我将拿这把伞
我会告诉你真相	我会告诉你真相
我会请你吃寿司	我会请你吃寿司
明天我将拜访他	明天我将拜访他
我正流着汗	我正流着汗
很高兴你是对的	很高兴你是对的
我只是到处看看	我只是到处看看
我不完全肯定	我不完全肯定
我莫得真的准备好	我没有真的准备好
我愿意接受建议	我愿意接受建议
对不起打扰你老	对不起打扰你了
我仍是这里的老板	我仍是这里的老板
我愿意帮汤姆	我愿意帮汤姆
我已经试过那个老	我已经试过那个了
我从没听说过汤姆	我从没听说过汤姆
我已经不喝啤酒老	我已经不喝啤酒了
汤姆住在波士顿吗	汤姆住在波士顿吗
大约十点钟吗	大约十点钟吗
那是我的照片吗	那是我的照片吗
这样真的值得吗	这样真的值得吗
这不是我的想法	这不是我的想法
它偶尔会发生	它偶尔会发生
它也是部好电影	它也是部好电影
下周可能会结冰	下周可能会结冰
它需要修理	它需要修理
真的令人丧气	真的令人丧气
不会花很多时间的	不会花很多时间的
差不多六点老	差不多六点了
快要六点老	快要六点了
我想要的就是这个	我想要的就是这个
它根本不是梦	它根本不是梦
这是其中一个原因	这是其中一个原因
它真是不舒服	它真是不舒服
它是你最喜欢的歌	它是你最喜欢的歌
把包包看好	把包包看好
保存在阴凉的地方	保存在阴凉的地方
京都值得游览	京都值得游览
让我们开车到湖边	让我们开车到湖边
生活很艰苦	生活很艰苦
伦敦在泰唔士河旁	伦敦在泰唔士河旁
人无法长生不死	人无法长生不死
玛丽会讲日语	玛丽会讲日语
玛丽刚刚回家	玛丽刚刚回家
玛丽是汤姆的秘书	玛丽是汤姆的秘书
我可以帮你照相吗	我可以帮你照相吗
也许那莫得发生	也许那没有发生
我妈妈不在家	我妈妈不在家
我父母离婚老	我父母离婚了
我的护照过期老	我的护照过期了
我打算买辆车	我打算买辆车
除老玛丽莫得人来	除了玛丽没有人来
莫得人跑在他前面	没有人跑在他前面
莫得人投反对票	没有人投反对票
莫得学生缺席	没有学生缺席
没人给我们机会	没人给我们机会
不是每个人都在笑	不是每个人都在笑
现在我需要你离开	现在我需要你离开
人们无法保持沉默	人们无法保持沉默
可能是值得的	可能是值得的
请把帐单给我	请把帐单给我
请给我菜单	请给我菜单
请保守这个秘密	请保守这个秘密
请马上离开	请马上离开
请把盐递给我	请把盐递给我
请再说一次	请再说一次
请寄信给我	请寄信给我
请出示您的票子	请出示您的票子
请告诉我它的事情	请告诉我它的事情
请用钢笔写	请用钢笔写
把它放回桌子上	把它放回桌子上
别切想它	别去想它
学校下周开学	学校下周开学
她总是对我微笑	她总是对我微笑
她问老他问题	她问了他问题
她问老我一个问题	她问了我一个问题
她很晚回家	她很晚回家
她不会读书写字	她不会读书写字
她哭得肝肠寸断	她哭得肝肠寸断
她不喜欢足球	她不喜欢足球
她浑身湿透老	她浑身湿透了
她有大量的书	她有大量的书
她现在正在吃午餐	她现在正在吃午餐
她不总是高兴	她不总是高兴
她立刻喜欢上他老	她立刻喜欢上他了
她的生活很寂寞	她的生活很寂寞
她一定是生病老	她一定是生病了
她说她感冒老	她说她感冒了
她给我看她的相簿	她给我看她的相簿
她日语说的很好	她日语说的很好
她照顾老我的狗	她照顾了我的狗
她现在老解你	她现在了解你
她生在美洲	她生在美洲
她穿着羊毛衣	她穿着羊毛衣
她英语说得很流利	她英语说得很流利
再给我举个例子	再给我举个例子
那你会给我啥子	那你会给我什么
有人在看着你	有人在看着你
有人呼救	有人呼救
你有时候真走运	你有时候真走运
别管我的事	别管我的事
雪梨离这里很远	雪梨离这里很远
拿本书读	拿本书读
拿你想要的	拿你想要的
那改变老一切	那改变了一切
这莫得任何意义	这没有任何意义
那家工厂生产玩具	那家工厂生产玩具
那一个真好	那一个真好
那条河是危险的	那条河是危险的
这是三天之前老	这是三天之前了
那就是你不是么	那就是你不是么
那天我不行	那天我不行
那是绝对正确的	那是绝对正确的
那是原创的想法	那是原创的想法
宝宝开始哭老	宝宝开始哭了
铃声在八点钟响起	铃声在八点钟响起
盒子几乎是空的	盒子几乎是空的
这个男孩害怕黑夜	这个男孩害怕黑夜
蝴蝶飞走老	蝴蝶飞走了
猫抓住老老鼠	猫抓住了老鼠
契约签订老	契约签订了
信写完老	信写完了
这个男人在吃面包	这个男人在吃面包
月亮已经出来老	月亮已经出来了
那音乐声音十分响	那音乐声音十分响
这消息让她很高兴	这消息让她很高兴
晚会很成功	晚会很成功
警察醉老	警察醉了
蛇诱惑老夏娃	蛇诱惑了夏娃
床单在床上	床单在床上
五和三的总和是八	五和三的总和是八
厕所塞住老	厕所塞住了
水结成冰老	水结成冰了
少一把叉子	少一把叉子
有后门	有后门
脏袜子散发臭气	脏袜子散发臭气
他们总是逃学	他们总是逃学
他们是仇敌	他们是仇敌
他们改变老制度	他们改变了制度
他们莫得立刻行动	他们没有立刻行动
他们不需要知道	他们不需要知道
他们释放老犯人	他们释放了犯人
他们昨天到这里的	他们昨天到这里的
他们下老车	他们下了车
他们嘲笑我的想法	他们嘲笑我的想法
他们生活得很幸福	他们生活得很幸福
他们慢慢地向前进	他们慢慢地向前进
他们要输老	他们要输了
他们会明白	他们会明白
他们自给自足	他们自给自足
他们还在波士顿	他们还在波士顿
这个苹果太小	这个苹果太小
这本书真的很旧	这本书真的很旧
这本书非常厚	这本书非常厚
这本字典是我的	这本字典是我的
这份设计很蠢	这份设计很蠢
这真可怕	这真可怕
这只火鸡味道很好	这只火鸡味道很好
这个能保暖	这个能保暖
那些花已经枯死老	那些花已经枯死了
那些花死老	那些花死了
现在售票	现在售票
汤姆和我是队友	汤姆和我是队友
汤姆不能原谅玛丽	汤姆不能原谅玛丽
汤姆决定不再等老	汤姆决定不再等了
汤姆没跟玛丽说话	汤姆没跟玛丽说话
汤姆不想来	汤姆不想来
汤姆不喜欢波士顿	汤姆不喜欢波士顿
汤姆不喜欢乳酪	汤姆不喜欢乳酪
Tom有台靓车	Tom有台靓车
汤姆还没完成	汤姆还没完成
汤姆向门走切	汤姆向门走去
汤姆有点担心	汤姆有点担心
汤姆是个怪人	汤姆是个怪人
汤姆是小提琴教师	汤姆是小提琴教师
汤姆要帮助我们	汤姆要帮助我们
汤姆在读一篇短文	汤姆在读一篇短文
汤姆在休一天假	汤姆在休一天假
汤姆比我高	汤姆比我高
汤姆在看影片	汤姆在看影片
汤姆不是好人	汤姆不是好人
汤姆不是个好工人	汤姆不是个好工人
汤姆昨晚差点死老	汤姆昨晚差点死了
汤姆需要鼓励	汤姆需要鼓励
汤姆没再见过她	汤姆没再见过她
汤姆拿起老刀	汤姆拿起了刀
汤姆和他的狗玩	汤姆和他的狗玩
汤姆放下他的铅笔	汤姆放下他的铅笔
汤姆跑得比我快	汤姆跑得比我快
汤姆坐在老树干上	汤姆坐在了树干上
汤姆说他很有钱	汤姆说他很有钱
汤姆应该很快就到	汤姆应该很快就到
汤姆认为有希望	汤姆认为有希望
汤姆晚餐迟到老	汤姆晚餐迟到了
汤姆的手在颤动	汤姆的手在颤动
明天是我生日	明天是我生日
试着不要哭	试着不要哭
把火转小一点	把火转小一点
我们买老张圆桌	我们买了张圆桌
我们没把它带回来	我们没把它带回来
我根本不需要这个	我根本不需要这个
我们不住在波士顿	我们不住在波士顿
我们有很多听众	我们有很多听众
我们明天有个测验	我们明天有个测验
我们让他养狗	我们让他养狗
我们点老中餐	我们点了中餐
我们最好叫醒汤姆	我们最好叫醒汤姆
我们在跟日本打仗	我们在跟日本打仗
我们今晚出切	我们今晚出去
我们在看着你	我们在看着你
昨晚你出切老吗	昨晚你出去了吗
我说的是真的	我说的是真的
多漂亮的花啊	多漂亮的花啊
多美好的家庭啊	多美好的家庭啊
你在这里做啥子	你在这里做什么
你觉得啷个样	你觉得怎么样
你要它干啥子	你要它干什么
他到底想干嘛	他到底想干嘛
那听起来像啥子	那听起来像什么
我要失切啥子	我要失去什么
你的房子如何	你的房子如何
你喜欢啥子运动	你喜欢什么运动
你在那里做啥子呢	你在那里做什么呢
汤姆的血型是甚么	汤姆的血型是甚么
那只鸟叫啥子名字	那只鸟叫什么名字
天气啷个样	天气怎么样
你啥子时候要回家	你什么时候要回家
你啥子时候上班	你什么时候上班
你现在在哪里	你现在在哪里
我能在哪里洗澡	我能在哪里洗澡
你想切哪里	你想去哪里
你们要切哪里	你们要去哪里
她现在住在哪儿	她现在住在哪儿
餐厅在哪里	餐厅在哪里
你在等哪个	你在等谁
你认为我们是哪个	你认为我们是谁
还有哪个知道它	还有谁知道它
还有哪个用这个房间	还有谁用这个房间
哪个要热巧克力	谁要热巧克力
你跟哪个说话呢	你跟谁说话呢
哪个写老这些故事	谁写了这些故事
哪个担心汤姆	谁担心汤姆
为甚么汤姆没被捕	为甚么汤姆没被捕
我明天能见到你吗	我明天能见到你吗
汤姆真要做吗	汤姆真要做吗
优胜者不使用药物	优胜者不使用药物
你能帮我一个忙吗	你能帮我一个忙吗
你和我一样高	你和我一样高
你随时可以回家	你随时可以回家
你将伴我同行	你将伴我同行
你们不再是小孩老	你们不再是小孩了
你现在可以删除它	你现在可以删除它
你现在可以开始老	你现在可以开始了
你不能靠汤姆	你不能靠汤姆
你不能有秘密	你不能有秘密
您不知道我是哪个	您不知道我是谁
你看来不大高兴	你看来不大高兴
你不必着急	你不必着急
你恨汤姆不是么	你恨汤姆不是么
你的眼睛真漂亮	你的眼睛真漂亮
你有着漂亮的腿	你有着漂亮的腿
你做得很好	你做得很好
你有足够的时间	你有足够的时间
你看起来很威严	你看起来很威严
你应该自己做	你应该自己做
您必须预先付钱	您必须预先付钱
你一定睡着老	你一定睡着了
你或者我会被选中	你或者我会被选中
你不应该出门	你不应该出门
你应该检查一哈	你应该检查一下
你应该很快那样做	你应该很快那样做
你应该亲自切	你应该亲自去
你本应该这样做的	你本应该这样做的
您本应该看看它的	您本应该看看它的
你不应该一个人切	你不应该一个人去
你应该戒菸	你应该戒菸
你应该切看医生	你应该去看医生
你应该更努力学习	你应该更努力学习
你不应该在这里等	你不应该在这里等
你游泳游得比我好	你游泳游得比我好
你最好尽快切做	你最好尽快去做
你最好不要出门	你最好不要出门
你晚一会就能明白	你晚一会就能明白
你完全正确	你完全正确
你开得太快老	你开得太快了
你真的很漂亮	你真的很漂亮
你真是太好老	你真是太好了
你是退出的那个	你是退出的那个
你鬼点子真多	你鬼点子真多
你已经把蛋糕吃老	你已经把蛋糕吃了
你的穿着非常好	你的穿着非常好
你太太在生你的气	你太太在生你的气
灯泡发光	灯泡发光
一年有十二个月	一年有十二个月
加一丁点盐	加一丁点盐
我只要自由	我只要自由
他们都不穷	他们都不穷
能让我用这个吗	能让我用这个吗
欢迎作任何评论	欢迎作任何评论
这些是你的女儿吗	这些是你的女儿吗
你下周来吗	你下周来吗
你是在找工作吗	你是在找工作吗
你在找工作吗	你在找工作吗
你身体不舒服吗	你身体不舒服吗
你在研读英语吗	你在研读英语吗
你在写信吗	你在写信吗
请你父亲帮你	请你父亲帮你
公车最终停老下来	公车最终停了下来
大鱼吃小鱼	大鱼吃小鱼
面包是面粉做的	面包是面粉做的
我能在这里拍照吗	我能在这里拍照吗
你能等一哈吗	你能等一下吗
你能待一会吗	你能待一会吗
当然她是正确的	当然她是正确的
奶酪是用奶做成的	奶酪是用奶做成的
显然的你错老	显然的你错了
明天来看看我	明天来看看我
尽早来	尽早来
进来门是开的	进来门是开的
你能载汤姆回家吗	你能载汤姆回家吗
爸爸给我买老书	爸爸给我买了书
汤姆感兴趣吗	汤姆感兴趣吗
你听见我说的老吗	你听见我说的了吗
你之前知道那个吗	你之前知道那个吗
你有时间再做吧	你有时间再做吧
我们的椅子够吗	我们的椅子够吗
你相信有幽灵吗	你相信有幽灵吗
你相信鬼存在吗	你相信鬼存在吗
你相信有鬼魂吗	你相信有鬼魂吗
你感觉轻松吗	你感觉轻松吗
你有字典吗	你有字典吗
你身上有铅笔吗	你身上有铅笔吗
你有红色的铅笔吗	你有红色的铅笔吗
你有多馀的钥匙吗	你有多馀的钥匙吗
你的钱够吗	你的钱够吗
你有很多朋友吗	你有很多朋友吗
你有其他家人吗	你有其他家人吗
你会跳舞吗	你会跳舞吗
你知道我住哪吗	你知道我住哪吗
你知道他们是哪个吗	你知道他们是谁吗
你喜欢草莓吗	你喜欢草莓吗
你喜欢吃水果吗	你喜欢吃水果吗
你需要救护车吗	你需要救护车吗
你打算出国吗	你打算出国吗
你真的需要车吗	你真的需要车吗
你认为它是陷阱吗	你认为它是陷阱吗
你会法语	你会法语
你想要伙伴吗	你想要伙伴吗
别让他们忘老我	别让他们忘了我
不要取笑人	不要取笑人
不要在这里打棒球	不要在这里打棒球
现在别想这事	现在别想这事
不用担心其他人	不用担心其他人
你莫得钱吗	你没有钱吗
你不想出切吗	你不想出去吗
数十人仍然失踪	数十人仍然失踪
教育从家庭开始	教育从家庭开始
英语简单易学	英语简单易学
连小孩儿都会做	连小孩儿都会做
全都靠它老	全都靠它了
火是非常危险的	火是非常危险的
火总是危险的	火总是危险的
第一印象很重要	第一印象很重要
食物不该被浪费	食物不该被浪费
给我一瓶葡萄酒	给我一瓶葡萄酒
给我点东西吃	给我点东西吃
请给我同样的东西	请给我同样的东西
爷爷买给我的	爷爷买给我的
你看过飞碟吗	你看过飞碟吗
我以前没见过你吗	我以前没见过你吗
他已经意识到它老	他已经意识到它了
他总是遵守诺言	他总是遵守诺言
我和他一起走	我和他一起走
他表现的像个疯子	他表现的像个疯子
他切年八月回来的	他去年八月回来的
他抓住老她的胳膊	他抓住了她的胳膊
他裁开老那个信封	他裁开了那个信封
他不顾我的忠告	他不顾我的忠告
他喝老一杯咖啡	他喝了一杯咖啡
昨天他喝老很多	昨天他喝了很多
他已经吃过午饭老	他已经吃过午饭了
他一点礼貌也莫得	他一点礼貌也没有
他急于要见你	他急于要见你
他武装到牙齿	他武装到牙齿
他坏透老	他坏透了
他跳上老桌子	他跳上了桌子
他认识很多人	他认识很多人
他非常喜欢音乐	他非常喜欢音乐
他喜欢独自旅行	他喜欢独自旅行
他住在我们隔壁	他住在我们隔壁
他照顾孩子	他照顾孩子
他可能迷路老	他可能迷路了
他可能会改变心意	他可能会改变心意
他一定是校长	他一定是校长
他常常走路切学校	他常常走路去学校
他吉他弹得很好	他吉他弹得很好
他非常喜欢棒球	他非常喜欢棒球
他拒绝相信我们	他拒绝相信我们
他很少切教堂	他很少去教堂
他昨晚睡得很好	他昨晚睡得很好
他研究老十年	他研究了十年
他游过老河	他游过了河
他自学法语	他自学法语
他感谢我的到来	他感谢我的到来
他切欧洲旅行老	他去欧洲旅行了
他脱掉老大衣	他脱掉了大衣
他拿出老他的护照	他拿出了他的护照
他试图自杀	他试图自杀
他以前是个好男孩	他以前是个好男孩
他走过这栋房子	他走过这栋房子
他想要切非洲	他想要去非洲
他被控告杀人罪	他被控告杀人罪
他被选为总统	他被选为总统
他那时正在弹钢琴	他那时正在弹钢琴
他被车辗过老	他被车辗过了
他是第一个来的	他是第一个来的
他一整天都很忙	他一整天都很忙
他忙老一整天	他忙了一整天
他坐汽车到波士顿	他坐汽车到波士顿
他边走边吹口哨	他边走边吹口哨
明天他会回来	明天他会回来
他明天会很忙	他明天会很忙
他明天有空	他明天有空
他不会听我的	他不会听我的
昨天他写信给我	昨天他写信给我
他会很高兴见到你	他会很高兴见到你
他的性情古怪	他的性情古怪
他切过体育馆	他去过体育馆
他对你非常生气	他对你非常生气
他非常擅长吉他	他非常擅长吉他
帮我抬起这包裹	帮我抬起这包裹
这是你的信	这是你的信
这儿有你的一封信	这儿有你的一封信
他的新车很棒	他的新车很棒
打网球啷个样	打网球怎么样
那啷个可能	那怎么可能
你们啷个读这个词	你们怎么读这个词
你的家庭有多大	你的家庭有多大
你有多少张CD	你有多少张CD
那里有多少队伍	那里有多少队伍
公车票价多少钱	公车票价多少钱
过老多长时间	过了多长时间
您多久见他一次	您多久见他一次
那幅画有多少年老	那幅画有多少年了
你的兄弟多高	你的兄弟多高
你老解汤姆多少	你了解汤姆多少
我承认他是对的	我承认他是对的
我同意你的建议	我同意你的建议
我同意他的观点	我同意他的观点
我同意这项建议	我同意这项建议
我几乎钓到老鱼	我几乎钓到了鱼
我几乎莫得遇见她	我几乎没有遇见她
我对音乐有兴趣	我对音乐有兴趣
我一切都很好	我一切都很好
我昨天到这里的	我昨天到这里的
我让汤姆在这里等	我让汤姆在这里等
我请他在这里等	我请他在这里等
我八点钟吃老早餐	我八点钟吃了早餐
我打赌他没搞定	我打赌他没搞定
我买老一双鞋子	我买了一双鞋子
我来感谢你	我来感谢你
我跟不上汤姆	我跟不上汤姆
我无法跟上你	我无法跟上你
莫得你我活不下切	没有你我活不下去
我承认我很累	我承认我很累
我应该告诉过你老	我应该告诉过你了
我决定当个医生老	我决定当个医生了
我不知道要做啥子	我不知道要做什么
我不知道该啷个办	我不知道该怎么办
我不是故意那样做	我不是故意那样做
我不在乎是否下雪	我不在乎是否下雪
我吃不下鸡皮	我吃不下鸡皮
我莫得敌人	我没有敌人
我莫得姐妹	我没有姐妹
我不知道他的地址	我不知道他的地址
我不知道说啥子	我不知道说什么
我不常笑	我不常笑
我不喜欢吃肉老	我不喜欢吃肉了
我不喜欢那件夹克	我不喜欢那件夹克
我再也不喜欢你老	我再也不喜欢你了
我不再爱你老	我不再爱你了
辣点儿没关系	辣点儿没关系
我不认为他会来的	我不认为他会来的
我不懂音乐	我不懂音乐
我不想听解释	我不想听解释
我不想独自前往	我不想独自前往
我不想失切你	我不想失去你
我不想伤害你	我不想伤害你
我怀疑汤姆是单身	我怀疑汤姆是单身
我想再来一杯啤酒	我想再来一杯啤酒
我今天感觉好多老	我今天感觉好多了
我每天上教堂	我每天上教堂
周日我切做礼拜	周日我去做礼拜
我也在这儿上学	我也在这儿上学
我上错老火车	我上错了火车
昨天我很早起床	昨天我很早起床
我在乡下长大	我在乡下长大
我要打几个电话	我要打几个电话
我把麦克风递给他	我把麦克风递给他
我有个坏消息	我有个坏消息
我有很多功课	我有很多功课
我对你有信心	我对你有信心
我今天莫得功课	我今天没有功课
我必须睡一哈觉	我必须睡一下觉
我必须到银行切	我必须到银行去
我听说汤姆被捕老	我听说汤姆被捕了
我帮她洗碗	我帮她洗碗
我希望他会等我	我希望他会等我
我知道他在看着我	我知道他在看着我
我知道啷个设陷阱	我知道怎么设陷阱
我对她一无所知	我对她一无所知
我知道你是对的	我知道你是对的
我知道你在做啥子	我知道你在做什么
我非常喜欢英语	我非常喜欢英语
我喜欢在队伍里	我喜欢在队伍里
我喜欢弹钢琴	我喜欢弹钢琴
我喜欢跟汤姆购物	我喜欢跟汤姆购物
我喜欢做我的作业	我喜欢做我的作业
我喜欢乘坐火车	我喜欢乘坐火车
我在车站遇见他	我在车站遇见他
我见到老王子真人	我见到了王子真人
我常常切看电影	我常常去看电影
我欠她10美元	我欠她10美元
我保证我会来	我保证我会来
我提供老他食物	我提供了他食物
我昨晚读书	我昨晚读书
我真喜欢这故事	我真喜欢这故事
我收到老一张请帖	我收到了一张请帖
我看见她进老房间	我看见她进了房间
我本不应该做的	我本不应该做的
我今天签老租约	我今天签了租约
我立刻打电话给她	我立刻打电话给她
我认为我犯老个错	我认为我犯了个错
我想我要哭老	我想我要哭了
我认为我做得够老	我认为我做得够了
我认为汤姆很酷	我认为汤姆很酷
我认为它不会成功	我认为它不会成功
我认为我们有麻烦	我认为我们有麻烦
我觉得您过火老	我觉得您过火了
我试着叫汤姆回来	我试着叫汤姆回来
我明白这概念	我明白这概念
我曾经像猪一样吃	我曾经像猪一样吃
我通常走切学校	我通常走去学校
我想让汤姆进监狱	我想让汤姆进监狱
我想要本好词典	我想要本好词典
我想要一点柳橙汁	我想要一点柳橙汁
我要些读的东西	我要些读的东西
我要相信汤姆	我要相信汤姆
我想预定一个房间	我想预定一个房间
我想给她一个惊喜	我想给她一个惊喜
我被外星人绑架老	我被外星人绑架了
我怕我会迟到	我怕我会迟到
我被要求在这里等	我被要求在这里等
我知道事实	我知道事实
我在冬天出生	我在冬天出生
我昨天在东京	我昨天在东京
她不在我很孤独	她不在我很孤独
我等着出租车	我等着出租车
我会出席会议的	我会出席会议的
我会跟她解释的	我会跟她解释的
我将要切参加会议	我将要去参加会议
我不会吃冰淇淋	我不会吃冰淇淋
我会尽快写信给你	我会尽快写信给你
我明天不在这儿	我明天不在这儿
我如果能做就做老	我如果能做就做了
我想要果汁	我想要果汁
我愿意帮你	我愿意帮你
我回家比较好	我回家比较好
我想要一杯柳橙汁	我想要一杯柳橙汁
我想要切伦敦	我想要去伦敦
我想看医生	我想看医生
我要看病	我要看病
我希望你切那里	我希望你去那里
我以前从未过它	我以前从未过它
我非常想离开	我非常想离开
我要暂时离开	我要暂时离开
我马上到那里	我马上到那里
我会给你带些咖啡	我会给你带些咖啡
我会给你这笔钱	我会给你这笔钱
我再也不会见她老	我再也不会见她了
我怕它是行不通的	我怕它是行不通的
我饿得像匹马	我饿得像匹马
我跟我父亲一样高	我跟我父亲一样高
我爱足球爱疯老	我爱足球爱疯了
我很高兴见到你	我很高兴见到你
真高兴有人告诉我	真高兴有人告诉我
很高兴再见到您	很高兴再见到您
很高兴再见到你	很高兴再见到你
我要坐下	我要坐下
我要告诉汤姆	我要告诉汤姆
我打算洗个澡	我打算洗个澡
我将切取我的车	我将去取我的车
我正在学如何打字	我正在学如何打字
我不是个母语者	我不是个母语者
我不想要问他	我不想要问他
我甚么也没找到	我甚么也没找到
我莫得向波士顿走	我没有向波士顿走
我只想到你	我只想到你
我现在正在踢足球	我现在正在踢足球
我对此负有责任	我对此负有责任
我没主意老	我没主意了
我住在我姑姑家	我住在我姑姑家
我厌倦老翻译	我厌倦了翻译
我喝醉老做不到	我喝醉了做不到
我现在很累	我现在很累
我以前被骗过	我以前被骗过
我已经做够老	我已经做够了
汤姆是个好人吗	汤姆是个好人吗
那就是它的叫法吗	那就是它的叫法吗
波士顿有动物园吗	波士顿有动物园吗
有它的应用吗	有它的应用吗
这条鱼还是活的吗	这条鱼还是活的吗
它属于我兄弟	它属于我兄弟
这啥子都说明不老	这什么都说明不了
那不真的重要	那不真的重要
它自动地发生老	它自动地发生了
可惜这是真的	可惜这是真的
说谎是错误的	说谎是错误的
这一定是个巧合	这一定是个巧合
这真的能派上用场	这真的能派上用场
看来他很快乐	看来他很快乐
它是由汤姆发现的	它是由汤姆发现的
这正如我想的一样	这正如我想的一样
它是基本人权	它是基本人权
有比莫得好	有比没有好
今天很热不是吗	今天很热不是吗
帮助你是我的责任	帮助你是我的责任
还没啷个准备好	还没怎么准备好
外面一片漆黑	外面一片漆黑
已经六点钟老	已经六点钟了
是时候洗个澡老	是时候洗个澡了
请相信我的话	请相信我的话
记好老这教训	记好了这教训
让他弹你的吉他	让他弹你的吉他
让我看一哈你的票	让我看一下你的票
让我跟汤姆说明	让我跟汤姆说明
让我给你说明	让我给你说明
让我看看它	让我看看它
让我给你沏茶	让我给你沏茶
让我思考一哈	让我思考一下
改天再说吧	改天再说吧
再找时间吧	再找时间吧
让我们再聚在一起	让我们再聚在一起
我们别自骗自老	我们别自骗自了
让我们休息一会儿	让我们休息一会儿
看我为你做老啥子	看我为你做了什么
许多朋友为他送行	许多朋友为他送行
玛丽必须切上学	玛丽必须去上学
我可以切洗手间吗	我可以去洗手间吗
我们能私下见见吗	我们能私下见见吗
妈妈有一个咖啡厅	妈妈有一个咖啡厅
我的血压很低	我的血压很低
我父亲开车切上班	我父亲开车去上班
我爸爸给我老游戏	我爸爸给我了游戏
我门牙突出	我门牙突出
我丈夫没在城里	我丈夫没在城里
我的工作是洗盘子	我的工作是洗盘子
我母亲十分生气	我母亲十分生气
我的房间面向花园	我的房间面向花园
我的肩膀很痠	我的肩膀很痠
我们队总是输	我们队总是输
我的表被偷老	我的表被偷了
没人应该担心	没人应该担心
没人试图帮汤姆	没人试图帮汤姆
莫得多少改变	没有多少改变
请把酒递给我	请把酒递给我
人们应该在跳舞	人们应该在跳舞
请选择一个人	请选择一个人
请不要用我的名字	请不要用我的名字
请给我送一块毯子	请给我送一块毯子
请敲门	请敲门
请穿上你的鞋子	请穿上你的鞋子
请说大声一点儿	请说大声一点儿
请告诉我汤姆很好	请告诉我汤姆很好
请告诉我你的名字	请告诉我你的名字
请打开收音机	请打开收音机
请先等他	请先等他
请浇花	请浇花
骄傲使人落后	骄傲使人落后
把枪放在桌子上	把枪放在桌子上
她和我是同学	她和我是同学
她决定和他结婚	她决定和他结婚
她不喜欢她的丈夫	她不喜欢她的丈夫
她与丈夫离婚	她与丈夫离婚
她上夜校	她上夜校
她不得不待在这儿	她不得不待在这儿
她是个很棒的女人	她是个很棒的女人
她现在正在工作	她现在正在工作
她是他的一切	她是他的一切
她钱不够	她钱不够
她派他切工作老	她派他去工作了
她马上离开老这里	她马上离开了这里
她也喜欢巧克力	她也喜欢巧克力
她唱得比他好	她唱得比他好
她寄这本书给我	她寄这本书给我
她把照片给他看	她把照片给他看
她边走边谈	她边走边谈
她昨天切那里	她昨天去那里
她是Tom的姐姐	她是Tom的姐姐
她莫得玛丽年纪大	她没有玛丽年纪大
我该取消通话吗	我该取消通话吗
有人推我到里面	有人推我到里面
退到绳子后面	退到绳子后面
打的切旅馆吧	打的去旅馆吧
让她中午过来	让她中午过来
十年是很长的时间	十年是很长的时间
为一切感谢你	为一切感谢你
不言而喻	不言而喻
那家伙让我发疯	那家伙让我发疯
这房子非常小	这房子非常小
这个玩具是木制的	这个玩具是木制的
我完全看不懂	我完全看不懂
那不是我的本意	那不是我的本意
这不是我的初衷	这不是我的初衷
这违反规则	这违反规则
这毫无意义	这毫无意义
您真是太好老	您真是太好了
那是我经常说的	那是我经常说的
那是我必须做的	那是我必须做的
那是汤姆承诺的	那是汤姆承诺的
请开到希尔顿酒店	请开到希尔顿酒店
这孩子哭老一整夜	这孩子哭了一整夜
这个毯子还是湿的	这个毯子还是湿的
这小男孩能数到十	这小男孩能数到十
课程八点半开始	课程八点半开始
狗被车撞老	狗被车撞了
门被踢开老	门被踢开了
燃油表坏老	燃油表坏了
警察在跟着他	警察在跟着他
这可怜的女孩瞎老	这可怜的女孩瞎了
天空中繁星点点	天空中繁星点点
天空布满星辰	天空布满星辰
雪消失老	雪消失了
学生都笑老	学生都笑了
他们的牛都很肥	他们的牛都很肥
少一把刀	少一把刀
少老一把勺子	少了一把勺子
无解	无解
曾经有一个意外	曾经有一个意外
莫得必要着急	没有必要着急
莫得我可以做的事	没有我可以做的事
这些东西不是我的	这些东西不是我的
他们变得很紧张	他们变得很紧张
他们称他胆小鬼	他们称他胆小鬼
他们不需要理由	他们不需要理由
他们给我钱没给够	他们给我钱没给够
他们考试不及格	他们考试不及格
他们莫得东西吃老	他们没有东西吃了
他们一定很恨我	他们一定很恨我
他们卖体育产品	他们卖体育产品
他们出发切野餐老	他们出发去野餐了
这个价格含老税	这个价格含了税
这文章是胡说	这文章是胡说
这表不走老	这表不走了
这颗钻石不是真的	这颗钻石不是真的
这是鸟类庇护所	这是鸟类庇护所
这是棵很高的树	这是棵很高的树
这不是很流行	这不是很流行
这个真好吃	这个真好吃
这是你唯一的机会	这是你唯一的机会
这把刀很锋利	这把刀很锋利
这让我很生气	这让我很生气
这个人靠不住的	这个人靠不住的
这衬衫需要熨	这衬衫需要熨
这次不一样	这次不一样
这一次不一样	这一次不一样
这手表是防水的	这手表是防水的
汤姆在我走后到老	汤姆在我走后到了
汤姆能游得很好	汤姆能游得很好
汤姆做得很出色	汤姆做得很出色
汤姆不吃红肉	汤姆不吃红肉
汤姆莫得发烧	汤姆没有发烧
汤姆必须再做一遍	汤姆必须再做一遍
汤姆啥子都没做	汤姆什么都没做
汤姆恐高	汤姆恐高
汤姆对每个人都好	汤姆对每个人都好
Tom正在找工作	Tom正在找工作
汤姆知道玛丽会来	汤姆知道玛丽会来
汤姆知道不同之处	汤姆知道不同之处
汤姆失切老信誉	汤姆失去了信誉
汤姆说玛丽饿老	汤姆说玛丽饿了
汤姆说他需要钱	汤姆说他需要钱
汤姆看来准备好老	汤姆看来准备好了
汤姆看来感冒老	汤姆看来感冒了
汤姆认为我太年轻	汤姆认为我太年轻
汤姆后退一步	汤姆后退一步
汤姆想当老板	汤姆想当老板
汤姆想切日本	汤姆想去日本
汤姆昨天缺席老	汤姆昨天缺席了
汤姆在藏甚么	汤姆在藏甚么
明天是母亲节	明天是母亲节
很遗憾下雨老	很遗憾下雨了
那时婴儿正在哭吗	那时婴儿正在哭吗
洗你的脸和手	洗你的脸和手
我们买老一磅的茶	我们买了一磅的茶
我们没点火	我们没点火
我们做我们想做的	我们做我们想做的
我们对他期望很多	我们对他期望很多
我们切学校学习	我们去学校学习
我们上同一所学校	我们上同一所学校
我们午后吃老顿饭	我们午后吃了顿饭
我们喝老些鸡汤	我们喝了些鸡汤
我们必须重新开始	我们必须重新开始
我们点太多食物老	我们点太多食物了
我们必须遵纪守法	我们必须遵纪守法
我们推迟老会议	我们推迟了会议
我们急忙跑向火	我们急忙跑向火
我们应该进行测试	我们应该进行测试
我们明天回来	我们明天回来
我们就像兄弟一样	我们就像兄弟一样
我们准备切做	我们准备去做
我们有充足的时间	我们有充足的时间
欢迎来到你的新家	欢迎来到你的新家
他们在这里做甚么	他们在这里做甚么
你现在在读甚么	你现在在读甚么
你们切看啥老	你们去看啥了
你必须吃啥子	你必须吃什么
你计划卖甚么	你计划卖甚么
你认为我想要甚么	你认为我想要甚么
你想知道啥子	你想知道什么
这个词是啥子意思	这个词是什么意思
你父亲是做啥子的	你父亲是做什么的
汤姆究竟在做啥子	汤姆究竟在做什么
他说的话不是真的	他说的话不是真的
你还想要啥子	你还想要什么
你几点回家	你几点回家
你会用它来做啥子	你会用它来做什么
你说的东西是胡扯	你说的东西是胡扯
汤姆出啥子事老	汤姆出什么事了
你家的地址是啥子	你家的地址是什么
你电话号码是多少	你电话号码是多少
你啥子时候回家	你什么时候回家
她啥子时候结婚的	她什么时候结婚的
游戏几点开始	游戏几点开始
你在哪里打网球	你在哪里打网球
他想切哪里	他想去哪里
它从哪里离开的	它从哪里离开的
汤姆的教室在哪里	汤姆的教室在哪里
这家咖啡馆在哪里	这家咖啡馆在哪里
您昨天在哪儿	您昨天在哪儿
他会选哪个	他会选哪个
哪个在弹钢琴	谁在弹钢琴
你为甚么不听	你为甚么不听
借个火好吗	借个火好吗
你想听吗	你想听吗
你是我的一切	你是我的一切
你只是说说而已	你只是说说而已
你并不完全错误	你并不完全错误
你随时可以来	你随时可以来
你不能这样活	你不能这样活
你不需要着急	你不需要着急
您莫得任何钱	您没有任何钱
你必须积极主动	你必须积极主动
你必须跟我来	你必须跟我来
你不能待在床上	你不能待在床上
你英语说得很流利	你英语说得很流利
你最好休息一哈	你最好休息一下
你是个美人	你是个美人
你在撒谎不是吗	你在撒谎不是吗
你部分正确	你部分正确
你胆子很大	你胆子很大
你的意志力很强	你的意志力很强
你做老个坏榜样	你做了个坏榜样
你的书在书桌上	你的书在书桌上
你的理由很充分	你的理由很充分
你儿子现在成人老	你儿子现在成人了
你的领带松老	你的领带松了
你的时间快用完老	你的时间快用完了
他突然发言老	他突然发言了
人人生来平等	人人生来平等
那些事都是真的	那些事都是真的
我该帮汤姆吗	我该帮汤姆吗
你是大学生吗	你是大学生吗
今晚有空吗	今晚有空吗
你确定汤姆高兴吗	你确定汤姆高兴吗
终于开始下雨老	终于开始下雨了
在这时候他到老	在这时候他到了
被拒绝是痛苦的	被拒绝是痛苦的
生病很无聊	生病很无聊
用你的鼻子呼吸	用你的鼻子呼吸
给我一杯水	给我一杯水
给我东西吃	给我东西吃
把你的孩子带来	把你的孩子带来
我能帮上忙吗	我能帮上忙吗
你能解开这个谜吗	你能解开这个谜吗
你法语说得好吗	你法语说得好吗
猫很讨厌吸尘器	猫很讨厌吸尘器
孩子们喜欢果汁	孩子们喜欢果汁
选你喜欢的	选你喜欢的
来跟我喝茶吧	来跟我喝茶吧
来嘛给我个机会	来嘛给我个机会
你能给我来点茶吗	你能给我来点茶吗
汤姆威胁过你吗	汤姆威胁过你吗
你完成工作老吗	你完成工作了吗
你租房子老吗	你租房子了吗
把披萨分成三份	把披萨分成三份
尽早做	尽早做
不要边走边看书	不要边走边看书
你相信神话传说吗	你相信神话传说吗
你们周日送货吗	你们周日送货吗
你有很多笔吗	你有很多笔吗
您有会员卡吗	您有会员卡吗
你喜欢日本菜吗	你喜欢日本菜吗
你喜欢日本料理吗	你喜欢日本料理吗
你喜欢盗版电影吗	你喜欢盗版电影吗
你喜欢喝红酒吗	你喜欢喝红酒吗
你后悔跟我结婚吗	你后悔跟我结婚吗
你想再要点茶吗	你想再要点茶吗
你想不想一起切	你想不想一起去
汤姆必须在那里吗	汤姆必须在那里吗
他有任何的兄弟吗	他有任何的兄弟吗
不要虐待动物	不要虐待动物
别再对我做这事老	别再对我做这事了
不要看不起别人	不要看不起别人
每个人都看向汤姆	每个人都看向汤姆
各位请安静	各位请安静
再给我五分钟	再给我五分钟
给我你的电话号码	给我你的电话号码
给这只狗一些肉	给这只狗一些肉
汤姆已经回来老吗	汤姆已经回来了吗
你被抢劫过吗	你被抢劫过吗
他同意我的意见	他同意我的意见
他总是说实话	他总是说实话
他问我是否很忙	他问我是否很忙
他问老我两个问题	他问了我两个问题
他从美国回来老	他从美国回来了
他也会说俄语	他也会说俄语
他无法跑得非常快	他无法跑得非常快
他莫得听音乐	他没有听音乐
他不信神	他不信神
他伸长老他的右手	他伸长了他的右手
他步行上学	他步行上学
他手里拿着一本书	他手里拿着一本书
他把头发剪短老	他把头发剪短了
他有各种各样的书	他有各种各样的书
他一直暗恋着她	他一直暗恋着她
他从没切过法国	他从没去过法国
他把它藏在老门后	他把它藏在了门后
他够开车的年纪老	他够开车的年纪了
他是我的一个邻居	他是我的一个邻居
他在自己房里玩	他在自己房里玩
他精通波斯语	他精通波斯语
他娶老一个空姐	他娶了一个空姐
他常常弹吉他	他常常弹吉他
他为她摘老些花	他为她摘了些花
他打网球打得很好	他打网球打得很好
他坐在溪流旁边	他坐在溪流旁边
他坐在河边	他坐在河边
他很少来看我	他很少来看我
他游泳游得比我好	他游泳游得比我好
他带我到车站	他带我到车站
他想切美国	他想去美国
他要你留在这里	他要你留在这里
他正在听音乐	他正在听音乐
他回店里切老	他回店里去了
他会让你吃灰的	他会让你吃灰的
他不会长寿	他不会长寿
他擅长放风筝	他擅长放风筝
他比你高得多	他比你高得多
他没违法	他没违法
他跑得非常快	他跑得非常快
他说话很直接	他说话很直接
帮我削一哈土豆	帮我削一下土豆
这里有个更好的	这里有个更好的
嗨请保持安静	嗨请保持安静
河马喜欢水	河马喜欢水
他的帽子没戴正	他的帽子没戴正
他的要求如下	他的要求如下
你啷个这样对我	你怎么这样对我
你啷个全都知道	你怎么全都知道
我该啷个切唐人街	我该怎么去唐人街
你有几个孩子	你有几个孩子
你有多少支铅笔	你有多少支铅笔
这把伞多少钱	这把伞多少钱
你用多少糖	你用多少糖
一共要多少钱	一共要多少钱
你的孩子多大老	你的孩子多大了
你的父母有多高	你的父母有多高
我接受老她的邀请	我接受了她的邀请
我确实同意你	我确实同意你
我同意那个意见	我同意那个意见
我同意您的意见	我同意您的意见
我是札幌的市民	我是札幌的市民
我怀孕四个月老	我怀孕四个月了
我要切打网球	我要去打网球
我没在写信	我没在写信
我不是正在写信	我不是正在写信
我很抱歉打扰你老	我很抱歉打扰你了
我最近很忙	我最近很忙
我在浇花	我在浇花
我感谢你的关心	我感谢你的关心
我请她出切约会	我请她出去约会
我相信他是幸福的	我相信他是幸福的
我买老台新电视机	我买了台新电视机
我昨天打电话给他	我昨天打电话给他
我可以照顾自己	我可以照顾自己
我现在不能问汤姆	我现在不能问汤姆
我也无法解释	我也无法解释
我不能破例	我不能破例
我不记得他的名字	我不记得他的名字
我找不到他的家	我找不到他的家
我决定出国留学老	我决定出国留学了
我今天没吃午餐	我今天没吃午餐
我没打算叫醒你	我没打算叫醒你
我莫得怀疑任何事	我没有怀疑任何事
我根本不信	我根本不信
我不在乎他做啥子	我不在乎他做什么
我不明白你的意思	我不明白你的意思
我莫得孩子	我没有孩子
我不介意被弄湿	我不介意被弄湿
我不相信商人	我不相信商人
我不懂德语	我不懂德语
我完全不懂	我完全不懂
我已经感觉够坏老	我已经感觉够坏了
我载她切城里老	我载她去城里了
我晚上很晚就寝	我晚上很晚就寝
我得到老一双新鞋	我得到了一双新鞋
我的眼睛进老些沙	我的眼睛进了些沙
我好像等太久老	我好像等太久了
我出老工伤	我出了工伤
我发烧老	我发烧了
我在七点吃早饭	我在七点吃早饭
我不知道她是哪个	我不知道她是谁
我有一些英文书	我有一些英文书
我最近没看到汤姆	我最近没看到汤姆
我很久莫得抽烟老	我很久没有抽烟了
希望我莫得烦到你	希望我没有烦到你
我希望汤姆欣赏它	我希望汤姆欣赏它
我知道我会赢	我知道我会赢
我知道汤姆饿老	我知道汤姆饿了
我喜欢狗和猫	我喜欢狗和猫
我喜欢器乐	我喜欢器乐
我喜欢学习外语	我喜欢学习外语
我也喜欢这颜色	我也喜欢这颜色
我喜欢打篮球	我喜欢打篮球
我喜欢搭火车旅行	我喜欢搭火车旅行
我回过头切	我回过头去
我可能搞错老	我可能搞错了
我肯定着凉老	我肯定着凉了
我需要一些邮票	我需要一些邮票
我更想继续坐着	我更想继续坐着
我宁愿搭飞机旅行	我宁愿搭飞机旅行
我跑得尽可能快	我跑得尽可能快
我真不这么想	我真不这么想
我记得第一次	我记得第一次
我记得给她写过信	我记得给她写过信
我亲眼看见老	我亲眼看见了
我每天都说英语	我每天都说英语
我星期天在家	我星期天在家
我站着等公车	我站着等公车
我每天读中文	我每天读中文
我每晚洗澡	我每晚洗澡
我觉的有一个问题	我觉的有一个问题
我认为汤姆乐观	我认为汤姆乐观
我看你长得像汤姆	我看你长得像汤姆
我认为你老解我	我认为你了解我
我想喝点啥子	我想喝点什么
我想当歌手	我想当歌手
我今晚想出切吃	我今晚想出去吃
我想弹吉他	我想弹吉他
我想看看你的母亲	我想看看你的母亲
我想和你切旅行	我想和你去旅行
我想看这部电影	我想看这部电影
我想让你准备好	我想让你准备好
我想让你等我	我想让你等我
我几乎被车撞到老	我几乎被车撞到了
我几乎不能工作老	我几乎不能工作了
我被无故辞退老	我被无故辞退了
我就要离开老	我就要离开了
我被雷劈老	我被雷劈了
我试着消磨时间	我试着消磨时间
上星期我非常地忙	上星期我非常地忙
我会战斗至死	我会战斗至死
我会把这本书给你	我会把这本书给你
但愿你切过那里	但愿你去过那里
我想要你的照片	我想要你的照片
我不会再试老	我不会再试了
我想要一杯水	我想要一杯水
请给我一杯茶	请给我一杯茶
我想吃点东西	我想吃点东西
我会给你这台相机	我会给你这台相机
我明天要切购物	我明天要去购物
我八点会跟你见面	我八点会跟你见面
我会亲自拜访您	我会亲自拜访您
我会永远记住你的	我会永远记住你的
下次我会更加努力	下次我会更加努力
我是个高中生	我是个高中生
我怕地震	我怕地震
我指望你的帮助	我指望你的帮助
很高兴再次见到你	很高兴再次见到你
我出切一会儿	我出去一会儿
我决定更努力读书	我决定更努力读书
我对历史有兴趣	我对历史有兴趣
我比你年轻得多	我比你年轻得多
我不擅长做木工	我不擅长做木工
我准备回家老	我准备回家了
我在告诉你真相	我在告诉你真相
我已经吃晚饭老	我已经吃晚饭了
我一直在找你	我一直在找你
我在本周做老许多	我在本周做了许多
我有个不错的想法	我有个不错的想法
我瘦老一点	我瘦了一点
我从没见汤姆笑	我从没见汤姆笑
我试过切联系汤姆	我试过去联系汤姆
遇到火灾打119	遇到火灾打119
这就是车站吗	这就是车站吗
你的家人好么	你的家人好么
你的作业做完老吗	你的作业做完了吗
这要看情况	这要看情况
这得看情况	这得看情况
听起来不像汤姆	听起来不像汤姆
它变得越来越大	它变得越来越大
这根本不是确定的	这根本不是确定的
做个赢家很好	做个赢家很好
时间还早不用起床	时间还早不用起床
对你来说还不太晚	对你来说还不太晚
昨晚雨下得很大	昨晚雨下得很大
它似乎很有趣	它似乎很有趣
切年下老很多雪	去年下了很多雪
做那事是我的责任	做那事是我的责任
那是唯一的出路	那是唯一的出路
很快就六点钟老	很快就六点钟了
是一幅漂亮的画	是一幅漂亮的画
它真是个好学校	它真是个好学校
这里已经是午夜老	这里已经是午夜了
已经9点老	已经9点了
这是朵人造花	这是朵人造花
那么做很难	那么做很难
很容易感冒	很容易感冒
戒烟难	戒烟难
它正是我所期待的	它正是我所期待的
这方便得多老	这方便得多了
将近三点老	将近三点了
有朋友真好	有朋友真好
这不关你的事	这不关你的事
这对任何人都不好	这对任何人都不好
显然地他撒老谎	显然地他撒了谎
真的不重要	真的不重要
她确实死老	她确实死了
嫉妒让他那样做	嫉妒让他那样做
请​​借我你的书	请​​借我你的书
让我想想	让我想想
玛丽很喜欢牛奶	玛丽很喜欢牛奶
我能问一些问题吗	我能问一些问题吗
请问您老人家高寿	请问您老人家高寿
他们可能有点啥子	他们可能有点什么
钱买不到幸福	钱买不到幸福
大自然很慷慨	大自然很慷慨
我的公寓在这附近	我的公寓在这附近
我的车子很耗油	我的车子很耗油
我女儿想要架钢琴	我女儿想要架钢琴
我爸爸在花园里	我爸爸在花园里
我的房子绝对保险	我的房子绝对保险
妈妈煮老十只蛋	妈妈煮了十只蛋
我妈妈是个好女人	我妈妈是个好女人
我邻居的狗死老	我邻居的狗死了
我父母还不老	我父母还不老
我的电话坏老	我的电话坏了
我的手表很准	我的手表很准
莫得人会听我说	没有人会听我说
星星莫得被看到	星星没有被看到
请不要打断我	请不要打断我
请保密	请保密
请借我你的刀	请借我你的刀
请把黄油递给我	请把黄油递给我
请说更大声一点	请说更大声一点
请说得更清楚些	请说得更清楚些
请脱下您的外套	请脱下您的外套
请再读一次	请再读一次
捲起你右边的袖子	捲起你右边的袖子
下周一开学	下周一开学
第二学期结束老	第二学期结束了
看看你能跳多高	看看你能跳多高
下周一再见	下周一再见
立即送医	立即送医
她叫老我很多次	她叫了我很多次
她给老我几本书	她给了我几本书
她周末病倒老	她周末病倒了
她反应很快	她反应很快
她有几百本书	她有几百本书
她不怕死	她不怕死
她喜欢拍照片	她喜欢拍照片
她活老很久	她活了很久
她一定在生我的气	她一定在生我的气
她说她病老	她说她病了
她教我如何游泳	她教我如何游泳
她以前和他住一起	她以前和他住一起
她通常很早起床	她通常很早起床
她小心翼翼地走	她小心翼翼地走
她被车子辗过老	她被车子辗过了
她化着浓妆	她化着浓妆
她赢老许多比赛	她赢了许多比赛
我们该吃午饭老吧	我们该吃午饭了吧
你不应该在学习吗	你不应该在学习吗
待在这里放松	待在这里放松
把平底锅离火	把平底锅离火
走左边的道路	走左边的道路
谢谢你邀请我	谢谢你邀请我
那本书很有趣	那本书很有趣
这真是很意外	这真是很意外
那就是我的感受	那就是我的感受
那就是汤姆想要的	那就是汤姆想要的
我吃苹果	我吃苹果
钟还没响	钟还没响
车往前走	车往前走
公司破产老	公司破产了
医生把它给老她	医生把它给了她
狗追兔子	狗追兔子
经济在复苏之中	经济在复苏之中
葬礼是昨天	葬礼是昨天
北极熊正在死切	北极熊正在死去
肉价下跌老	肉价下跌了
问题已解决	问题已解决
这里的服务很糟糕	这里的服务很糟糕
火车准时到老	火车准时到了
宇宙浩瀚无边	宇宙浩瀚无边
警告被忽视	警告被忽视
天气转好老	天气转好了
这个年轻人是医生	这个年轻人是医生
他们明天举行婚礼	他们明天举行婚礼
几乎莫得任何书籍	几乎没有任何书籍
还莫得任何评论	还没有任何评论
书桌上有食物	书桌上有食物
有很多人	有很多人
有人在那里	有人在那里
这些苹果很大	这些苹果很大
他们正在读她的书	他们正在读她的书
他们在看一部电影	他们在看一部电影
他们成老密友	他们成了密友
他们有相同的嗜好	他们有相同的嗜好
他们有12个孩子	他们有12个孩子
他们让我很生气	他们让我很生气
他们曾彼此微笑	他们曾彼此微笑
这张书桌是木制的	这张书桌是木制的
这家伙像个狐狸	这家伙像个狐狸
这是常有的事	这是常有的事
这是给你的礼物	这是给你的礼物
恶劣的天气	恶劣的天气
这只是个假设	这只是个假设
这是我的妹妹	这是我的妹妹
这个比那个更小	这个比那个更小
这不是我点的食物	这不是我点的食物
这工作报酬很高	这工作报酬很高
这个老房子闹鬼	这个老房子闹鬼
这不便宜是吗	这不便宜是吗
这种威士忌太烈老	这种威士忌太烈了
把球丢还给我	把球丢还给我
现在有票	现在有票
汤姆投票弃权	汤姆投票弃权
汤姆总是让我笑	汤姆总是让我笑
汤姆和我要做完老	汤姆和我要做完了
汤姆问老几个问题	汤姆问了几个问题
汤姆买老个手机	汤姆买了个手机
汤姆买老新笔记本	汤姆买了新笔记本
汤姆买老张机票	汤姆买了张机票
汤姆爬上老墙	汤姆爬上了墙
汤姆哭老很长时间	汤姆哭了很长时间
汤姆应当被责备	汤姆应当被责备
汤姆不同意做	汤姆不同意做
汤姆三个月前死老	汤姆三个月前死了
汤姆最终明白老	汤姆最终明白了
汤姆非常谨慎	汤姆非常谨慎
汤姆害怕每个人	汤姆害怕每个人
汤姆非常的浪漫	汤姆非常的浪漫
汤姆留着小胡子	汤姆留着小胡子
汤姆在起居室里	汤姆在起居室里
汤姆现在没在电视	汤姆现在没在电视
汤姆参加老讨论	汤姆参加了讨论
汤姆无故地笑	汤姆无故地笑
汤姆喜欢科幻	汤姆喜欢科幻
汤姆可能已经走老	汤姆可能已经走了
汤姆可能是素食者	汤姆可能是素食者
汤姆莫得再出现	汤姆没有再出现
汤姆下棋下得很好	汤姆下棋下得很好
汤姆答应再试一次	汤姆答应再试一次
汤姆说它是钻石	汤姆说它是钻石
汤姆看来随和	汤姆看来随和
汤姆输入密码	汤姆输入密码
汤姆想要别的东西	汤姆想要别的东西
汤姆想说声再见	汤姆想说声再见
汤姆的汽车被偷老	汤姆的汽车被偷了
汤姆头发蓬乱	汤姆头发蓬乱
会有训练	会有训练
切除这块肉的脂肪	切除这块肉的脂肪
麻烦说来就来	麻烦说来就来
真爱不会变老	真爱不会变老
麻烦开灯一哈	麻烦开灯一下
请开灯	请开灯
往右边转动钥匙	往右边转动钥匙
服务生我要点菜	服务生我要点菜
我们都非常想你	我们都非常想你
我们一起在学校	我们一起在学校
我们不怕死	我们不怕死
我们把它当作恩惠	我们把它当作恩惠
我们能做点大事	我们能做点大事
我们不常做	我们不常做
我们聊老一会儿	我们聊了一会儿
我们有很多家具	我们有很多家具
我们有一个大超市	我们有一个大超市
我们必须拔除杂草	我们必须拔除杂草
我们必须考虑它	我们必须考虑它
我们晚上锁门	我们晚上锁门
我们应该切请医生	我们应该去请医生
我们应该叫警察来	我们应该叫警察来
我们该报警	我们该报警
我们游泳到天黑	我们游泳到天黑
我们认为他诚实	我们认为他诚实
我们想知道真相	我们想知道真相
我们早晚要死	我们早晚要死
我们又遇上问题老	我们又遇上问题了
你打算赢吗	你打算赢吗
昨晚你累老吗	昨晚你累了吗
汤姆说的不是真的	汤姆说的不是真的
你在读哪本书	你在读哪本书
你用啥子打开的	你用什么打开的
你星期天都做啥子	你星期天都做什么
你要我做啥子	你要我做什么
这钥匙能打开啥子	这钥匙能打开什么
公园里发生老甚么	公园里发生了甚么
你有啥子症状	你有什么症状
你说的不是真的	你说的不是真的
汤姆为老甚么生气	汤姆为了甚么生气
你的狗啷个老	你的狗怎么了
客厅里有啥子	客厅里有什么
我的腿有啥子毛病	我的腿有什么毛病
我的计画有问题吗	我的计画有问题吗
电影啥子时候开始	电影什么时候开始
她想切哪里	她想去哪里
哪个买这种艺术品	谁买这种艺术品
你为啥子来老日本	你为什么来了日本
你啷个不睡觉呢	你怎么不睡觉呢
你为甚么不跟他讲	你为甚么不跟他讲
六点钟你方便吗	六点钟你方便吗
六点您行吗	六点您行吗
你明天在这里吗	你明天在这里吗
葡萄酒帮助消化	葡萄酒帮助消化
你要来点儿沙拉吗	你要来点儿沙拉吗
每隔一行写	每隔一行写
昨天是我的生日	昨天是我的生日
你别小看老他	你别小看了他
你累老不是吗	你累了不是吗
你可以用我的字典	你可以用我的字典
你甚么也没写	你甚么也没写
你不必打电话给我	你不必打电话给我
你不需要做这事	你不需要做这事
你咖啡喝得太多老	你咖啡喝得太多了
你最好马上走	你最好马上走
你对女人有一套	你对女人有一套
你知道不是那样的	你知道不是那样的
你必须控制自己	你必须控制自己
你不该吃太多	你不该吃太多
你不该大声说话	你不该大声说话
你肯定认为我傻	你肯定认为我傻
你应该和Tom说	你应该和Tom说
你该把事实说出来	你该把事实说出来
你明白不是吗	你明白不是吗
你被不公平地对待	你被不公平地对待
你最好亲自切	你最好亲自去
你今天最好不要切	你今天最好不要去
你最好放松	你最好放松
你有一天会明白	你有一天会明白
你莫得我聪明	你没有我聪明
你的想法是对的	你的想法是对的
你在正确的轨道上	你在正确的轨道上
你来得很早	你来得很早
你的英语正在进步	你的英语正在进步
你的来信使我快乐	你的来信使我快乐
暴风过后是宁静	暴风过后是宁静
否极泰来	否极泰来
几乎没人相信她	几乎没人相信她
永远要对自己诚实	永远要对自己诚实
动物怕火	动物怕火
哪个都会犯错	谁都会犯错
在家里有问题吗	在家里有问题吗
你是日本学生吗	你是日本学生吗
你是日语学生吗	你是日语学生吗
你能演奏管风琴吗	你能演奏管风琴吗
你明天出切吗	你明天出去吗
你要回来吗	你要回来吗
银行九点开门	银行九点开门
篮球可真是有意思	篮球可真是有意思
给我一桶水	给我一桶水
带上你的学生卡	带上你的学生卡
麻烦给我菜单	麻烦给我菜单
能给我打个折么	能给我打个折么
你能给我一些钱吗	你能给我一些钱吗
胡萝卜要三美元	胡萝卜要三美元
你过来试试看	你过来试试看
我能私下见你吗	我能私下见你吗
你能借我这本书吗	你能借我这本书吗
你能不说那个老吗	你能不说那个了吗
她来这里放松的吗	她来这里放松的吗
你有带吹风机吗	你有带吹风机吗
你吹风机带来老吗	你吹风机带来了吗
你们都讲法语吗	你们都讲法语吗
做你认为正确的事	做你认为正确的事
你喝很多牛奶吗	你喝很多牛奶吗
你有任何淡啤酒吗	你有任何淡啤酒吗
你必须做晚饭吗	你必须做晚饭吗
你经常出国吗	你经常出国吗
你认为我美吗	你认为我美吗
你认为那公平吗	你认为那公平吗
你有比汤姆重吗	你有比汤姆重吗
汤姆有女朋友吗	汤姆有女朋友吗
那能改变甚么吗	那能改变甚么吗
做起来不会很久	做起来不会很久
不要拐弯抹角	不要拐弯抹角
别想吓唬我	别想吓唬我
不要担心过切	不要担心过去
你不想用我的吗	你不想用我的吗
电很有用	电很有用
这里的人不说英语	这里的人不说英语
父亲在浇花	父亲在浇花
把水装满桶子	把水装满桶子
法语是我的母语	法语是我的母语
你切过罗马吗	你去过罗马吗
他得知老他的错误	他得知了他的错误
他要求我们安静	他要求我们安静
他吃老一盒巧克力	他吃了一盒巧克力
他今天带老午饭	他今天带了午饭
他能轻松地读英语	他能轻松地读英语
他决定戒菸老	他决定戒菸了
他甚至叫你傻瓜	他甚至叫你傻瓜
他甚至骂我傻瓜	他甚至骂我傻瓜
他面带笑容	他面带笑容
他切过很多地方	他去过很多地方
他有三个姐姐	他有三个姐姐
他侵犯老她的隐私	他侵犯了她的隐私
他邀请我切他家	他邀请我去他家
他是个网球高手	他是个网球高手
他是个钓鱼专家	他是个钓鱼专家
他不关心钱	他不关心钱
他全速驾驶着	他全速驾驶着
他偶尔会来拜访我	他偶尔会来拜访我
他刮老他的胡子	他刮了他的胡子
他学老英国历史	他学了英国历史
他也学习汉语	他也学习汉语
他叫我洗脸	他叫我洗脸
他吓得脸色发白	他吓得脸色发白
有人看见他上楼	有人看见他上楼
他是一名高中学生	他是一名高中学生
他呆在他阿姨家	他呆在他阿姨家
他写长信	他写长信
他的讲座很长	他的讲座很长
他的来信让我不安	他的来信让我不安
事情啷个变糟的	事情怎么变糟的
你啷个赚钱	你怎么赚钱
您的行李箱有多重	您的行李箱有多重
你的生意进展如何	你的生意进展如何
你有多少本书	你有多少本书
6乘以4是多少	6乘以4是多少
6的4倍是多少	6的4倍是多少
手续费是多少	手续费是多少
你有多少钱	你有多少钱
你需要多少钱	你需要多少钱
你的长子几岁	你的长子几岁
我其实没那么说	我其实没那么说
我生性乐观	我生性乐观
我对英语感兴趣	我对英语感兴趣
我只是切散散步	我只是去散散步
我现在正在弹钢琴	我现在正在弹钢琴
我对他感到厌烦老	我对他感到厌烦了
我比平常晚到	我比平常晚到
我相信汤姆会切做	我相信汤姆会去做
我参加戏剧社	我参加戏剧社
我从中国到日本	我从中国到日本
没眼镜我可以读	没眼镜我可以读
我不能借你任何钱	我不能借你任何钱
我跟不上你的逻辑	我跟不上你的逻辑
上个月我感冒老	上个月我感冒了
我从一个大家庭来	我从一个大家庭来
我全靠自己	我全靠自己
我不想来这里	我不想来这里
我不属于任何社团	我不属于任何社团
我不那么在意	我不那么在意
我今天没课	我今天没课
我莫得四个兄弟	我没有四个兄弟
我不懂你啥子意思	我不懂你什么意思
我不喜欢这番话	我不喜欢这番话
我不喜欢穿袜子	我不喜欢穿袜子
我认为你不应该	我认为你不应该
我不再相信他老	我不再相信他了
我不想独自生活	我不想独自生活
我不想玩纸牌	我不想玩纸牌
我和他谈得很愉快	我和他谈得很愉快
我不同情汤姆	我不同情汤姆
我大致上同意她	我大致上同意她
我睡老个好觉	我睡了个好觉
我和大家相处	我和大家相处
我出身贫寒	我出身贫寒
我和她有一段长谈	我和她有一段长谈
我和她聊得很愉快	我和她聊得很愉快
我本来打算切那里	我本来打算去那里
我有一双红鞋子	我有一双红鞋子
我比汤姆有钱	我比汤姆有钱
我对你毫无隐瞒	我对你毫无隐瞒
我必须切见汤姆	我必须去见汤姆
我听说他们挺好	我听说他们挺好
我听到她唱歌	我听到她唱歌
我知道这天要来	我知道这天要来
我知道他来自哪里	我知道他来自哪里
我喜欢穿长袜	我喜欢穿长袜
我在树林里迷路老	我在树林里迷路了
我喜欢看电影	我喜欢看电影
我爱百香果汁	我爱百香果汁
我爱看脱口秀	我爱看脱口秀
我让他刷房子	我让他刷房子
我需要一双新鞋	我需要一双新鞋
我只花老三美元	我只花了三美元
我看到他在打棒球	我看到他在打棒球
我今天看来很幸运	我今天看来很幸运
我还是不会说法语	我还是不会说法语
我还莫得找到工作	我还没有找到工作
我夜以继日地读书	我夜以继日地读书
我支持政治改革	我支持政治改革
我重视自身的健康	我重视自身的健康
我认为汤姆还活着	我认为汤姆还活着
我认为你说得很对	我认为你说得很对
我设法不让你醒	我设法不让你醒
我要一打奶油泡芙	我要一打奶油泡芙
我想写篇文章	我想写篇文章
我想让你歇歇	我想让你歇歇
我想把它给你看	我想把它给你看
我有点紧张	我有点紧张
我被蚊子叮老	我被蚊子叮了
我上个月在波士顿	我上个月在波士顿
上个月我在伦敦	上个月我在伦敦
我难受三周老	我难受三周了
我莫得暗示甚么	我没有暗示甚么
我会为你做任何事	我会为你做任何事
我会待到明天	我会待到明天
我会带你切游泳	我会带你去游泳
我希望能跟你走	我希望能跟你走
我希望能与你谈话	我希望能与你谈话
但愿我现在在巴黎	但愿我现在在巴黎
我马上做比较好	我马上做比较好
麻烦我要一张收据	麻烦我要一张收据
我想要成为吉他手	我想要成为吉他手
我想睡点觉	我想睡点觉
我想切商场	我想去商场
我更愿意自己做	我更愿意自己做
我能协助你	我能协助你
我会给你些提示	我会给你些提示
我会给你这个坠饰	我会给你这个坠饰
我会跟你一起回家	我会跟你一起回家
我把窗户打开一点	我把窗户打开一点
我会重新考虑此事	我会重新考虑此事
我会给汤姆发信息	我会给汤姆发信息
明天我会呆在家里	明天我会呆在家里
我是世界公民	我是世界公民
我餵我的孩子母乳	我餵我的孩子母乳
我在听收音机	我在听收音机
我啥子都不怕	我什么都不怕
我很满意我的工作	我很满意我的工作
我怕野兽	我怕野兽
我还是为那生气	我还是为那生气
我确定汤姆会同意	我确定汤姆会同意
我确定它将会很有趣	我确定它将会很有趣
我己经被惩罚老	我己经被惩罚了
我一直不信任汤姆	我一直不信任汤姆
我找到老个住处	我找到了个住处
一万日元够吗	一万日元够吗
船上有医生吗	船上有医生吗
公园里有动物园吗	公园里有动物园吗
这是你要的吗	这是你要的吗
今天特别热	今天特别热
很有可能还会下雨	很有可能还会下雨
真是烦死老	真是烦死了
看来汤姆在说谎	看来汤姆在说谎
那是一见钟情	那是一见钟情
那只是你的想象	那只是你的想象
这只是你的想象	这只是你的想象
跟你没半毛钱关系	跟你没半毛钱关系
它不是猫它是狗	它不是猫它是狗
这只是时间的问题	这只是时间的问题
又开始下雨老	又开始下雨了
这是正确的事情	这是正确的事情
现在道歉也迟老	现在道歉也迟了
这间房里很热	这间房里很热
语言不是他的强项	语言不是他的强项
马上离开房间	马上离开房间
借我一些书看	借我一些书看
我给你再买一个吧	我给你再买一个吧
让我们快点做完吧	让我们快点做完吧
一起吃晚饭吧	一起吃晚饭吧
看那栋高楼	看那栋高楼
玛丽长得像她妈妈	玛丽长得像她妈妈
玛丽日语说得很慢	玛丽日语说得很慢
我能和你谈谈吗	我能和你谈谈吗
或许我该切帮汤姆	或许我该去帮汤姆
可能汤姆紧张老	可能汤姆紧张了
我哥哥会开车	我哥哥会开车
我爸爸不喜欢足球	我爸爸不喜欢足球
我的梦想是切日本	我的梦想是去日本
我父亲有家餐馆	我父亲有家餐馆
我的家乡非常漂亮	我的家乡非常漂亮
我的母亲在做蛋糕	我的母亲在做蛋糕
我母亲是个酒鬼	我母亲是个酒鬼
我儿子比我高	我儿子比我高
没人听汤姆说话	没人听汤姆说话
莫得人要切找你	没有人要去找你
莫得人能无所不知	没有人能无所不知
活到老学到老	活到老学到老
哪个也不要摸这个	谁也不要摸这个
这些钱都不是你的	这些钱都不是你的
其他人不那么乐观	其他人不那么乐观
此处禁止停车	此处禁止停车
请把奶油递给我	请把奶油递给我
人们需要止住仇恨	人们需要止住仇恨
人们以前笑话我们	人们以前笑话我们
请大家都保持安静	请大家都保持安静
请不要说得那么快	请不要说得那么快
请不要说得这么快	请不要说得这么快
请给我看看其他的	请给我看看其他的
请即刻停止	请即刻停止
请脱掉你的鞋子	请脱掉你的鞋子
请用铅笔写	请用铅笔写
多放一点糖	多放一点糖
请记在一张帐单上	请记在一张帐单上
明天在学校见	明天在学校见
她跟我同年	她跟我同年
她招呼我进来	她招呼我进来
她过老马路	她过了马路
她莫得很多钱	她没有很多钱
她死于胃癌	她死于胃癌
她莫得票	她没有票
她特别喜爱音乐	她特别喜爱音乐
她走路切上学	她走路去上学
她的手提包被偷老	她的手提包被偷了
她该接受她的命运	她该接受她的命运
她的声音令人愉快	她的声音令人愉快
她莫得审美感	她没有审美感
她将切立山	她将去立山
她成功地开车老	她成功地开车了
她每天都打网球	她每天都打网球
她说一点阿拉伯语	她说一点阿拉伯语
她听着音乐	她听着音乐
那时她正在洗碗	那时她正在洗碗
她穿着长靴	她穿着长靴
她穿着漂亮的洋装	她穿着漂亮的洋装
她是汤姆的妹妹	她是汤姆的妹妹
绵羊提供我们羊毛	绵羊提供我们羊毛
有人跟我说这件事	有人跟我说这件事
说英语很有用	说英语很有用
请深呼吸	请深呼吸
照顾好你自己	照顾好你自己
走右边的道路	走右边的道路
告诉我你的感受	告诉我你的感受
告诉我正确的答案	告诉我正确的答案
告诉我拿它做啥子	告诉我拿它做什么
谢谢你我吃饱老	谢谢你我吃饱了
那不关他的事	那不关他的事
那部电影值得一看	那部电影值得一看
那该让你高兴	那该让你高兴
那是个有趣的主意	那是个有趣的主意
空气有点冷	空气有点冷
船还能看见	船还能看见
这个男孩很有前途	这个男孩很有前途
这个男孩戴着眼镜	这个男孩戴着眼镜
大楼有20层	大楼有20层
猫在桌子底下	猫在桌子底下
鸡肉还不够熟	鸡肉还不够熟
医生把他叫老回来	医生把他叫了回来
狗向着我跑老过来	狗向着我跑了过来
狗被卡车撞老	狗被卡车撞了
选举一致通过老	选举一致通过了
展览现在已经开放	展览现在已经开放
会议取消老	会议取消了
月光真美	月光真美
飞机就要降落老	飞机就要降落了
天然气的价格上升	天然气的价格上升
屋里挤满老人	屋里挤满了人
船起老火	船起了火
学生们回来老	学生们回来了
老师患老重感冒	老师患了重感冒
我们两个是学生	我们两个是学生
书桌上有一个包	书桌上有一个包
墙上有张地图	墙上有张地图
一片寂静无声	一片寂静无声
有三个幸存者	有三个幸存者
莫得人在房间里	没有人在房间里
没啥子可原谅的	没什么可原谅的
这些数字总数不符	这些数字总数不符
他们辍学老	他们辍学了
他们住在河对面	他们住在河对面
他们把我当小孩	他们把我当小孩
他们给果树浇水	他们给果树浇水
他们赢老许多比赛	他们赢了许多比赛
这辆车很容易操控	这辆车很容易操控
这与你有直接关系	这与你有直接关系
这房子不出售	这房子不出售
这是一朵美丽的花	这是一朵美丽的花
这是个重要事件	这是个重要事件
这将永远继续下切	这将永远继续下去
这件事非常紧急	这件事非常紧急
这钢琴真便宜	这钢琴真便宜
此句有歧义	此句有歧义
这张桌子是木制的	这张桌子是木制的
这个词源于拉丁语	这个词源于拉丁语
那些郁金香很美丽	那些郁金香很美丽
那是困难时期	那是困难时期
汤姆和我是好朋友	汤姆和我是好朋友
汤姆老是发牢骚	汤姆老是发牢骚
汤姆不知道那是哪个	汤姆不知道那是谁
汤姆看来不高兴	汤姆看来不高兴
汤姆走路切上学	汤姆走路去上学
汤姆要做个决定	汤姆要做个决定
汤姆是一个大嘴巴	汤姆是一个大嘴巴
汤姆年纪大切世老	汤姆年纪大去世了
汤姆不合作	汤姆不合作
汤姆有低血压	汤姆有低血压
汤姆得保护自己	汤姆得保护自己
汤姆还没打给玛莉	汤姆还没打给玛莉
汤姆是个大方的人	汤姆是个大方的人
汤姆现在在卫生间	汤姆现在在卫生间
汤姆傻得难以置信	汤姆傻得难以置信
汤姆不打算留下	汤姆不打算留下
汤姆也刚离婚	汤姆也刚离婚
汤姆喜欢打棒球	汤姆喜欢打棒球
汤姆与玛丽对视	汤姆与玛丽对视
汤姆需要洗他的车	汤姆需要洗他的车
汤姆从不想试试	汤姆从不想试试
汤姆在昨晚切世老	汤姆在昨晚去世了
汤姆应该听说这个	汤姆应该听说这个
汤姆应该更清楚	汤姆应该更清楚
汤姆刚好准时到老	汤姆刚好准时到了
汤姆会说一点法语	汤姆会说一点法语
汤姆也学法语	汤姆也学法语
汤姆让玛丽幚约翰	汤姆让玛丽幚约翰
汤姆告诉我他紧张	汤姆告诉我他紧张
汤姆想要一杯水	汤姆想要一杯水
汤姆早上切过那里	汤姆早上去过那里
汤姆明天会切那里	汤姆明天会去那里
汤姆再也不做老	汤姆再也不做了
汤姆可能会切那里	汤姆可能会去那里
汤姆的护照过期老	汤姆的护照过期了
汤姆的演讲非常好	汤姆的演讲非常好
排球很有意思	排球很有意思
我们也切老庙里	我们也去了庙里
我们选她为主席	我们选她为主席
我们喜欢看电视	我们喜欢看电视
我们谈得不错	我们谈得不错
我们在树荫下休息	我们在树荫下休息
我们还有一点时间	我们还有一点时间
我们昨天踢老足球	我们昨天踢了足球
我们总要遵守法律	我们总要遵守法律
我们在公园里散步	我们在公园里散步
我们也不得不做	我们也不得不做
昨天你不在家吗	昨天你不在家吗
你今晚在做啥子	你今晚在做什么
你说的是啥子	你说的是什么
你昨天晚上做啥子	你昨天晚上做什么
你昨晚做老啥子	你昨晚做了什么
你们午饭吃老啥子	你们午饭吃了什么
这只鸟叫作啥子	这只鸟叫作什么
如果汤姆还活着呢	如果汤姆还活着呢
你的生日是几号	你的生日是几号
她是怎样的人呢	她是怎样的人呢
这是啥子石头	这是什么石头
你订阅老啥子报纸	你订阅了什么报纸
你丈夫叫啥子	你丈夫叫什么
你何时来日本的	你何时来日本的
请问鸡蛋在哪里	请问鸡蛋在哪里
你哪儿来的主意	你哪儿来的主意
你昨天切哪里老	你昨天去哪里了
售票窗口在哪里	售票窗口在哪里
婚礼在哪儿举行	婚礼在哪儿举行
我该在哪儿等您	我该在哪儿等您
你认为他们是哪个	你认为他们是谁
你想跟哪个说话	你想跟谁说话
这把枪是属于哪个的	这把枪是属于谁的
究竟哪个要负责	究竟谁要负责
哪个发明老电话	谁发明了电话
哪个组织老这次会议	谁组织了这次会议
哪个会想雇汤姆	谁会想雇汤姆
哪个将当选主席呢	谁将当选主席呢
在门口的女孩是哪个	在门口的女孩是谁
你们为啥子想杀我	你们为什么想杀我
你为啥子想杀我	你为什么想杀我
为啥子它是必要的	为什么它是必要的
你不要点咖啡吗	你不要点咖啡吗
能借我支铅笔吗	能借我支铅笔吗
哇好久不见老	哇好久不见了
你和我是好朋友	你和我是好朋友
你和我同龄	你和我同龄
你总是在抱怨	你总是在抱怨
你总是在看电视	你总是在看电视
你问题太多老	你问题太多了
你做老必要的事	你做了必要的事
你不必切那里	你不必去那里
你看来不喜欢汤姆	你看来不喜欢汤姆
你有副好嗓音	你有副好嗓音
你一点都没变	你一点都没变
你真的一点没变	你真的一点没变
你让我感到很内疚	你让我感到很内疚
您上学可能会迟到	您上学可能会迟到
你可能听说过	你可能听说过
你没必要马上切做	你没必要马上去做
你应该切看牙医	你应该去看牙医
你应该要更小心	你应该要更小心
你不应该做的	你不应该做的
你们两个应该结婚	你们两个应该结婚
你迟到老不是吗	你迟到了不是吗
你最好吃点东西	你最好吃点东西
你要当妈老	你要当妈了
你看起来不难看	你看起来不难看
您记性不太好	您记性不太好
人无法逃避过切	人无法逃避过去
出现老新困难	出现了新困难
防微杜渐	防微杜渐
这些书都是我的	这些书都是我的
大象有长鼻子	大象有长鼻子
周年纪念很重要	周年纪念很重要
你们在听我说吗	你们在听我说吗
你还在办公室里吗	你还在办公室里吗
你对此不高兴吗	你对此不高兴吗
小心点它很锋利	小心点它很锋利
两兄弟都是音乐家	两兄弟都是音乐家
我能些吃的东西吗	我能些吃的东西吗
选择你喜欢的球拍	选择你喜欢的球拍
做饭太费时间老	做饭太费时间了
请你拿这个好吗	请你拿这个好吗
汤姆以前是教师吗	汤姆以前是教师吗
你在家吃过老吗	你在家吃过了吗
这是你自己做的吗	这是你自己做的吗
你昨天喝茶老吗	你昨天喝茶了吗
你昨晚看电视老吗	你昨晚看电视了吗
你相信他说的话吗	你相信他说的话吗
你有东西吃吗	你有东西吃吗
你有任何话要说吗	你有任何话要说吗
你在听我说吗	你在听我说吗
你知道啷个使用吗	你知道怎么使用吗
你喜欢看电影吗	你喜欢看电影吗
你在那里学中文吗	你在那里学中文吗
你认为汤姆有钱吗	你认为汤姆有钱吗
您想吃点啥子吗	您想吃点什么吗
你想不想要这工作	你想不想要这工作
你想跟汤姆说话吗	你想跟汤姆说话吗
洗衣服是我的工作	洗衣服是我的工作
不要相信她说的话	不要相信她说的话
别倚着墙	别倚着墙
别放老那个犯人	别放了那个犯人
别在教室里说话	别在教室里说话
英语在日本被学习	英语在日本被学习
每个人都向往幸福	每个人都向往幸福
所有人都喜欢偷懒	所有人都喜欢偷懒
每个人都买不起车	每个人都买不起车
每个人都在等汤姆	每个人都在等汤姆
早上要早起	早上要早起
发生老啥子好事吗	发生了什么好事吗
有过任何改变吗	有过任何改变吗
你选好专业老吗	你选好专业了吗
你切过京都吗	你去过京都吗
你读过这本书吗	你读过这本书吗
你洗过车子老吗	你洗过车子了吗
他携款潜逃	他携款潜逃
他完成老他的使命	他完成了他的使命
我走之后他到达老	我走之后他到达了
他能为你暗箱操作	他能为你暗箱操作
他无法深呼吸	他无法深呼吸
他不知道说啥子好	他不知道说什么好
他和他兄弟不一样	他和他兄弟不一样
他不是总来晚	他不是总来晚
他莫得任何朋友	他没有任何朋友
他莫得朋友	他没有朋友
他开车不是吗	他开车不是吗
他病老一星期	他病了一星期
他迟到莫得理由	他迟到没有理由
他帮我做我的功课	他帮我做我的功课
他有点像他的父亲	他有点像他的父亲
他比我高一个头	他比我高一个头
他是一个数学天才	他是一个数学天才
他和他爸爸一样高	他和他爸爸一样高
他跟我过不切	他跟我过不去
他只是跟你开玩笑	他只是跟你开玩笑
他缺乏经验	他缺乏经验
他可能很快就到老	他可能很快就到了
他不可能成功	他不可能成功
他很少心情很好	他很少心情很好
取悦他很难	取悦他很难
他依旧充满活力	他依旧充满活力
他不适合当老师	他不适合当老师
他喜欢看报纸	他喜欢看报纸
他看起来忠厚老实	他看起来忠厚老实
他走进老房间	他走进了房间
他每天都打垒球	他每天都打垒球
他假装莫得听见我	他假装没有听见我
他假装是一名医生	他假装是一名医生
他真的很热爱音乐	他真的很热爱音乐
他真的想见你	他真的想见你
他65岁退老休	他65岁退了休
他急忙出老办公室	他急忙出了办公室
他似乎已经说老谎	他似乎已经说了谎
他开始说英语老	他开始说英语了
他告诉我不要说谎	他告诉我不要说谎
他带她出切兜风老	他带她出去兜风了
他发誓要戒烟	他发誓要戒烟
他被逐出老学校	他被逐出了学校
他站在老门口	他站在了门口
他明天会在家	他明天会在家
他很快就会回来	他很快就会回来
昨天他写好老信	昨天他写好了信
他宁愿不吃这个	他宁愿不吃这个
他总是对我很亲切	他总是对我很亲切
他没你高	他没你高
他的村屋在海岸上	他的村屋在海岸上
他的房子又小又旧	他的房子又小又旧
切开车兜风怎样	去开车兜风怎样
今晚出切啷个样	今晚出去怎么样
汤姆是如何出狱的	汤姆是如何出狱的
你啷个完成的	你怎么完成的
考得如何	考得如何
你是啷个认识他的	你是怎么认识他的
你啷个解释那个	你怎么解释那个
你怎样作出的解释	你怎样作出的解释
您啷个看这个问题	您怎么看这个问题
你的学校有多远	你的学校有多远
你住在那里多久老	你住在那里多久了
他不在这有多久老	他不在这有多久了
你在这里多久老	你在这里多久了
你认识她多久老	你认识她多久了
它将停在那里多久	它将停在那里多久
你要多少个苹果	你要多少个苹果
他有多少册图书	他有多少册图书
有多少人能做	有多少人能做
你买老多少东西	你买了多少东西
你给汤姆多少钱	你给汤姆多少钱
这支笔多少钱	这支笔多少钱
我欠你多少钱	我欠你多少钱
你觉得汤姆有多大	你觉得汤姆有多大
你认为她多大	你认为她多大
我陪她散步	我陪她散步
我承认我大意老	我承认我大意了
我完全赞同你	我完全赞同你
我的右眼瞎老	我的右眼瞎了
我迫切需要冷饮	我迫切需要冷饮
今天我要切看他	今天我要去看他
我现在在打排球	我现在在打排球
我按时到老学校	我按时到了学校
我相信他们说的话	我相信他们说的话
我花10美元买的	我花10美元买的
我能看穿你的谎言	我能看穿你的谎言
我能游泳过河	我能游泳过河
我能教你怎样游泳	我能教你怎样游泳
我挑不出他的毛病	我挑不出他的毛病
我受不老他的傲慢	我受不了他的傲慢
我乘船过老河	我乘船过了河
我没听懂他说的话	我没听懂他说的话
我不是很喜欢它	我不是很喜欢它
我甚至没考虑过	我甚至没考虑过
我莫得和她相处过	我没有和她相处过
自私不是我的本意	自私不是我的本意
我很希望你会再来	我很希望你会再来
我甚至不想试试	我甚至不想试试
我不乘公交切学校	我不乘公交去学校
我啥子经验都莫得	我什么经验都没有
我不认为他会说好	我不认为他会说好
我不认为他会同意	我不认为他会同意
它们中莫得我要的	它们中没有我要的
我不想看起来傻	我不想看起来傻
我不想跟你说	我不想跟你说
我期待你能准时	我期待你能准时
我想切旅行	我想去旅行
我今天想出门	我今天想出门
我对她的评价很好	我对她的评价很好
今天我头痛欲裂	今天我头痛欲裂
我今天有点发烧	我今天有点发烧
我切老理发店	我去了理发店
我刚刚吃完	我刚刚吃完
我有很多事情要做	我有很多事情要做
我无家可回	我无家可回
我不知道要穿啥子	我不知道要穿什么
我得问你点事	我得问你点事
我听到老敲门声	我听到了敲门声
我希望万事如意	我希望万事如意
我希望人们满意	我希望人们满意
我知道我做错老	我知道我做错了
我爱她她也爱我	我爱她她也爱我
我喜欢逗人笑	我喜欢逗人笑
我必须弥补损失	我必须弥补损失
我得找人商量一哈	我得找人商量一下
我仅仅吃老口面包	我仅仅吃了口面包
我打算与她分手	我打算与她分手
我打算绝不再喝酒	我打算绝不再喝酒
我昨晚真尽兴	我昨晚真尽兴
我记得锁门老	我记得锁门了
我不该说那个	我不该说那个
我不应该登出	我不应该登出
我悄悄把信给老他	我悄悄把信给了他
我有时候打破规矩	我有时候打破规矩
我昨晚待在家里	我昨晚待在家里
我又熬夜老	我又熬夜了
我昨晚睡得晚	我昨晚睡得晚
我认为它很难	我认为它很难
看来我们得打包老	看来我们得打包了
我以为他是我弟弟	我以为他是我弟弟
我忽略老事实	我忽略了事实
我试着不切想老	我试着不去想了
我每隔一天拜访他	我每隔一天拜访他
我今晚想吃些批萨	我今晚想吃些批萨
我想学习如何游泳	我想学习如何游泳
我非常想见到他	我非常想见到他
我想跟你老板谈	我想跟你老板谈
我想让我们一起做	我想让我们一起做
我没切派对	我没去派对
我昨晚很累老	我昨晚很累了
我将不出席派对	我将不出席派对
我不会再见他老	我不会再见他了
我会给你看图片	我会给你看图片
我会等到她来	我会等到她来
我祝你生日快乐	我祝你生日快乐
我希望你在我身边	我希望你在我身边
我下周日不在家	我下周日不在家
今天我不加班	今天我不加班
我现在想回家老	我现在想回家了
我想买半个蛋糕	我想买半个蛋糕
我想切看你的父亲	我想去看你的父亲
我想见你的姐姐	我想见你的姐姐
我为你充当导游	我为你充当导游
我将6点回来	我将6点回来
我10分钟后回来	我10分钟后回来
我在本周日上班	我在本周日上班
我明年17岁	我明年17岁
我会立刻开始	我会立刻开始
我会给点你好东西	我会给点你好东西
我将考虑考虑	我将考虑考虑
我下周切还你钱	我下周去还你钱
我下星期三见你	我下星期三见你
今天我也会努力的	今天我也会努力的
我会等到四点	我会等到四点
我对你有一点生气	我对你有一点生气
恐怕我现在得走老	恐怕我现在得走了
我打算向她求婚	我打算向她求婚
我希望那会发生	我希望那会发生
我在阅读他的报告	我在阅读他的报告
你能来我真高兴	你能来我真高兴
我开始不喜欢她老	我开始不喜欢她了
我正在图书馆学习	我正在图书馆学习
我相信他会成功	我相信他会成功
我在谈我的朋友	我在谈我的朋友
我是这房子的主人	我是这房子的主人
我厌倦老她的抱怨	我厌倦了她的抱怨
我习惯晚睡	我习惯晚睡
我担心我的体重	我担心我的体重
我一直在学开车	我一直在学开车
我爬过两次富士山	我爬过两次富士山
我有许多问题	我有许多问题
我试图找到Tom	我试图找到Tom
我以前听过这笑话	我以前听过这笑话
我听说你病老	我听说你病了
我把袜子穿破老	我把袜子穿破了
冰岛曾属于丹麦	冰岛曾属于丹麦
在我看来你错老	在我看来你错了
Tom能说法文吗	Tom能说法文吗
说英语很难吗	说英语很难吗
桌子上有只猫吗	桌子上有只猫吗
房间里有人吗	房间里有人吗
屋里有人吗	屋里有人吗
摸这条蛇安全吗	摸这条蛇安全吗
这对他莫得影响	这对他没有影响
从这儿看景色很美	从这儿看景色很美
这完全是浪费时间	这完全是浪费时间
它比我想的容易	它比我想的容易
祸不单行	祸不单行
很快就要三点钟老	很快就要三点钟了
这是很严重的病	这是很严重的病
雪下老一整夜	雪下了一整夜
呆在家里很无聊	呆在家里很无聊
就在转角处	就在转角处
不难理解	不难理解
没啥子好担心的	没什么好担心的
让油远离火	让油远离火
神户是著名的港口	神户是著名的港口
京都有很多所大学	京都有很多所大学
把书放在原处	把书放在原处
让我给你一些建议	让我给你一些建议
让我把你介绍给他	让我把你介绍给他
稍微随意一点	稍微随意一点
林肯释放老奴隶	林肯释放了奴隶
听而且听仔细	听而且听仔细
玛丽帮她妈妈做饭	玛丽帮她妈妈做饭
玛丽怀老双胞胎	玛丽怀了双胞胎
我的生日在星期日	我的生日在星期日
我父亲无法抬起它	我父亲无法抬起它
我父亲身体很健康	我父亲身体很健康
自然充满老神秘	自然充满了神秘
没人回答我的问题	没人回答我的问题
没人支持他的动议	没人支持他的动议
这里没人会打扰你	这里没人会打扰你
没人想要你那样做	没人想要你那样做
现在握个手和解吧	现在握个手和解吧
现在哪个要帮你	现在谁要帮你
父母爱自己的孩子	父母爱自己的孩子
把盐递给我好吗	把盐递给我好吗
人们应该尽力而为	人们应该尽力而为
请告诉我你的地址	请告诉我你的地址
她总是随心所欲	她总是随心所欲
她决定辞切工作	她决定辞去工作
她一支铅笔也莫得	她一支铅笔也没有
她想切散步	她想去散步
她有预言的能力	她有预言的能力
她陶醉在幸福里	她陶醉在幸福里
她将生孩子	她将生孩子
她精通法语	她精通法语
她是个合格的护士	她是个合格的护士
她正在浇花	她正在浇花
她取笑老她的丈夫	她取笑了她的丈夫
她尽可能地快跑	她尽可能地快跑
她说她以前很快乐	她说她以前很快乐
她说老她很幸福	她说了她很幸福
好像她病老	好像她病了
她感谢我们的帮助	她感谢我们的帮助
她被哈佛录取老	她被哈佛录取了
她几乎被车撞到	她几乎被车撞到
她忙于家务	她忙于家务
她握着一把伞	她握着一把伞
她五点前不会回来	她五点前不会回来
她五点钟才会回来	她五点钟才会回来
唱歌是她的强项	唱歌是她的强项
六除以二得三	六除以二得三
吸烟有害健康	吸烟有害健康
有些食物令人口渴	有些食物令人口渴
说英语是不容易的	说英语是不容易的
请脱下你的袜子	请脱下你的袜子
老师也会犯错	老师也会犯错
告诉汤姆一切都好	告诉汤姆一切都好
告诉他该切哪儿	告诉他该去哪儿
十间房屋被烧毁老	十间房屋被烧毁了
谢谢你的耐心	谢谢你的耐心
谢谢你的解释	谢谢你的解释
那顿饭简直好极老	那顿饭简直好极了
那是个美好的瞬间	那是个美好的瞬间
那不难是吧	那不难是吧
这就是他所说的	这就是他所说的
那不重要不是么	那不重要不是么
酸性腐蚀老金属	酸性腐蚀了金属
回答偏老	回答偏了
观众人数庞大	观众人数庞大
群鸟南翔	群鸟南翔
男孩学会老阅读	男孩学会了阅读
公交车迟到老	公交车迟到了
小丑做老个鬼脸	小丑做了个鬼脸
期限近老	期限近了
设计本身有问题	设计本身有问题
医生可能说过	医生可能说过
长胡子的是汤姆	长胡子的是汤姆
损失是无法估计的	损失是无法估计的
这药创造老奇迹	这药创造了奇迹
这只老鼠跑进洞里	这只老鼠跑进洞里
社区是安静的	社区是安静的
这位老人下老公车	这位老人下了公车
压力很巨大	压力很巨大
这个价格不合理	这个价格不合理
这份报告完全错误	这份报告完全错误
房间里家具齐全	房间里家具齐全
房里有股烟味	房里有股烟味
天空完全变黑老	天空完全变黑了
明天有足球比赛	明天有足球比赛
商店周一关门	商店周一关门
条纹是水平的	条纹是水平的
电视机坏老	电视机坏了
火车应当准点到	火车应当准点到
今晚天公作美	今晚天公作美
桌上有个杯子	桌上有个杯子
这没啥子好担心的	这没什么好担心的
明天会下雪喔	明天会下雪喔
这些洋装太大	这些洋装太大
这些橘子很酸	这些橘子很酸
他们不怕死	他们不怕死
他们决定结婚老	他们决定结婚了
他们礼拜天上教堂	他们礼拜天上教堂
他们休息老一会儿	他们休息了一会儿
他们坐车切芝加哥	他们坐车去芝加哥
他们不会再见面老	他们不会再见面了
这是张舒服的椅子	这是张舒服的椅子
这是个危险的任务	这是个危险的任务
这真是有趣	这真是有趣
这是我的公司地址	这是我的公司地址
他砸坏的是这扇窗	他砸坏的是这扇窗
这个药会帮助你	这个药会帮助你
这支笔不太好用	这支笔不太好用
这应该很有意思	这应该很有意思
三的立方是二十七	三的立方是二十七
汤姆啥子都记不住	汤姆什么都记不住
汤姆今晚不能工作	汤姆今晚不能工作
汤姆要求有人解释	汤姆要求有人解释
汤姆不必谢我	汤姆不必谢我
汤姆不明白这事	汤姆不明白这事
T喝老点柳橙汁	T喝了点柳橙汁
汤姆昨天到波士顿	汤姆昨天到波士顿
汤姆手里拿着饮料	汤姆手里拿着饮料
汤姆预计玛莉会来	汤姆预计玛莉会来
汤姆有高血压	汤姆有高血压
汤姆有三个姐姐	汤姆有三个姐姐
汤姆帮我搬老家	汤姆帮我搬了家
汤姆要睡着老	汤姆要睡着了
汤姆比你有名	汤姆比你有名
汤姆真瘦不是么	汤姆真瘦不是么
汤姆感觉不太好	汤姆感觉不太好
汤姆就是不懂	汤姆就是不懂
汤姆真的不喜欢你	汤姆真的不喜欢你
汤姆拒绝付账	汤姆拒绝付账
汤姆看来有点困惑	汤姆看来有点困惑
汤姆穿着鞋睡老	汤姆穿着鞋睡了
汤姆谈老他的学校	汤姆谈了他的学校
汤姆想洗个澡	汤姆想洗个澡
汤姆想做炸薯条	汤姆想做炸薯条
汤姆被送回老波士顿	汤姆被送回了波士顿
汤姆的狗咬他玩	汤姆的狗咬他玩
明天我切巴黎	明天我去巴黎
宝贵的时间已失切	宝贵的时间已失去
我们有信心获胜	我们有信心获胜
我们莫得太多时间	我们没有太多时间
我们认为这不严肃	我们认为这不严肃
我们喜欢打棒球	我们喜欢打棒球
我们一年聚一次	我们一年聚一次
我们的关系非常好	我们的关系非常好
我们必须一起切	我们必须一起去
我们要老结此事	我们要了结此事
我们得洗衣服	我们得洗衣服
我们还没考虑	我们还没考虑
我们建议提高收费	我们建议提高收费
我们想要更多信息	我们想要更多信息
我们切年切老伦敦	我们去年去了伦敦
我们找不到汤姆	我们找不到汤姆
我们明天解决它	我们明天解决它
我们晚会再谈这事	我们晚会再谈这事
我们尽力而为	我们尽力而为
我们在跟时间斗争	我们在跟时间斗争
我们哪个都不怕	我们谁都不怕
你对那是认真的吗	你对那是认真的吗
可惜你不会跳舞	可惜你不会跳舞
你周末有啥子计划	你周末有什么计划
你午饭吃的啥子	你午饭吃的什么
你放学以后干啥子	你放学以后干什么
您做啥子工作为生	您做什么工作为生
你想跟我说啥子	你想跟我说什么
汤姆知道我的啥子	汤姆知道我的什么
会起必会落	会起必会落
你为啥子来这儿	你为什么来这儿
你们来这儿干嘛	你们来这儿干嘛
你到底啷个回事嘛	你到底怎么回事嘛
你穿几号的鞋子	你穿几号的鞋子
你刚说老啥子	你刚说了什么
会议啷个样	会议怎么样
你说的话莫得道理	你说的话没有道理
那背后是啥子意思	那背后是什么意思
那些人从哪来的	那些人从哪来的
那天晚上你在哪里	那天晚上你在哪里
警察局在哪里	警察局在哪里
我们以后往哪走	我们以后往哪走
最近的车站在哪里	最近的车站在哪里
你属于哪个社团	你属于哪个社团
你最喜欢哪一队	你最喜欢哪一队
你是哪一队的迷	你是哪一队的迷
哪个能说清不同点	谁能说清不同点
这本书是哪个的	这本书是谁的
你的英语老师是哪个	你的英语老师是谁
哪个解决老这个难题	谁解决了这个难题
哪个教你跳舞的	谁教你跳舞的
他们在讨论哪个	他们在讨论谁
哪个会想住在这里	谁会想住在这里
哪个写老这两封信	谁写了这两封信
哪个会信呢	谁会信呢
你为甚么还不结婚	你为甚么还不结婚
为啥子她早回家老	为什么她早回家了
你为啥子这么早起	你为什么这么早起
为啥子你企图逃走	为什么你企图逃走
你要喝点茶吗	你要喝点茶吗
你想出国吗	你想出国吗
你有义务还债	你有义务还债
你不会来是吗	你不会来是吗
有你的电话	有你的电话
你没找到不是么	你没找到不是么
你切上学不是吗	你去上学不是吗
你只要问就好老	你只要问就好了
你该打扫你的房间	你该打扫你的房间
你必须得自信	你必须得自信
你看起来健康如昔	你看起来健康如昔
你看来是个小女孩	你看来是个小女孩
你应该立即开始	你应该立即开始
你应该把大衣穿上	你应该把大衣穿上
你不该抽那么多烟	你不该抽那么多烟
你说话像个当官的	你说话像个当官的
你不会迟到是吗	你不会迟到是吗
我对你的脸很熟悉	我对你的脸很熟悉
你的预言成真老	你的预言成真了
你的问题莫得答案	你的问题没有答案
你的看法过于乐观	你的看法过于乐观
狗会对陌生人叫	狗会对陌生人叫
兔子和乌龟赛跑	兔子和乌龟赛跑
很多树被砍倒	很多树被砍倒
我们都非常喜欢你	我们都非常喜欢你
世界各地都说英语	世界各地都说英语
仔细回答我的问题	仔细回答我的问题
你在听英语吗	你在听英语吗
你确定汤姆能做吗	你确定汤姆能做吗
务必要买一些牛奶	务必要买一些牛奶
我能和老师说话吗	我能和老师说话吗
你弟弟会开车吗	你弟弟会开车吗
你能重复一遍吗	你能重复一遍吗
十二月有三十一天	十二月有三十一天
你是不是刚认识他	你是不是刚认识他
我需要切派对吗	我需要去派对吗
你真信吗	你真信吗
你有外套和帽子吗	你有外套和帽子吗
你有旅馆名录吗	你有旅馆名录吗
你已经有孩子老吗	你已经有孩子了吗
你有啥子事要说吗	你有什么事要说吗
您有啥子事要说吗	您有什么事要说吗
你有弟弟吗	你有弟弟吗
你知道啷个煮肉吗	你知道怎么煮肉吗
你每天读法语吗	你每天读法语吗
汤姆莫得朋友吗	汤姆没有朋友吗
不要从右边咬	不要从右边咬
不要超速	不要超速
不要侵犯她的隐私	不要侵犯她的隐私
不要流露你的感情	不要流露你的感情
不要捉弄老人家	不要捉弄老人家
请不要打开此门	请不要打开此门
不要小看我的力量	不要小看我的力量
不要低估我的力量	不要低估我的力量
在美国说英语	在美国说英语
欧洲人喜欢喝酒	欧洲人喜欢喝酒
大家需要冷静下来	大家需要冷静下来
请定期填写	请定期填写
坦率地说他错老	坦率地说他错了
请给我你的意见	请给我你的意见
已经取得巨大进展	已经取得巨大进展
邮差已经来过老吗	邮差已经来过了吗
你曾经切过法国吗	你曾经去过法国吗
你染过头发吗	你染过头发吗
你写过博客吗	你写过博客吗
他十分钟前到这里	他十分钟前到这里
他昨晚很晚回家	他昨晚很晚回家
他昨天来看你	他昨天来看你
他网球打得很好	他网球打得很好
他还会说俄语	他还会说俄语
切年他转校老	去年他转校了
切年他换老学校	去年他换了学校
他设计老新建筑	他设计了新建筑
他一个朋友都莫得	他一个朋友都没有
他莫得孩子	他没有孩子
他开卡车到达拉斯	他开卡车到达拉斯
他给老她一张纸	他给了她一张纸
他免费把它给老我	他免费把它给了我
他开车切办公室	他开车去办公室
他的职业是医生	他的职业是医生
他对室内灰尘过敏	他对室内灰尘过敏
他将竞选市长	他将竞选市长
他擅长骑马	他擅长骑马
他这个人很难相处	他这个人很难相处
他有可能赢得比赛	他有可能赢得比赛
他有几分像学者	他有几分像学者
他浑身是债	他浑身是债
他对纽约老如指掌	他对纽约了如指掌
他看得懂中文	他看得懂中文
他明天出发切中国	他明天出发去中国
他在森林中迷老路	他在森林中迷了路
他让我做他的助理	他让我做他的助理
他拍拍我的肩膀	他拍拍我的肩膀
他送她一个洋娃娃	他送她一个洋娃娃
他假装是我的朋友	他假装是我的朋友
他把书放在老桌上	他把书放在了桌上
他射老鹿一箭	他射了鹿一箭
他有时会来看我	他有时会来看我
他周游世界各地	他周游世界各地
他想还清贷款	他想还清贷款
他嫉妒我的成功	他嫉妒我的成功
他习惯老旅行	他习惯了旅行
他比我大两岁	他比我大两岁
健康胜过财富	健康胜过财富
她的书非常有趣	她的书非常有趣
她的皮肤比雪还白	她的皮肤比雪还白
嘿你在这做啥子	嘿你在这做什么
他的书非常有趣	他的书非常有趣
他的衣服总是很臭	他的衣服总是很臭
他的说明并不清楚	他的说明并不清楚
他儿子想当律师	他儿子想当律师
您啷个敢这样说话	您怎么敢这样说话
你啷个认识玛丽的	你怎么认识玛丽的
我啷个跟汤姆解释	我怎么跟汤姆解释
你想啷个处理	你想怎么处理
到机场有多远	到机场有多远
到火车站有多远	到火车站有多远
你准备待多久	你准备待多久
这条绳子能撑多久	这条绳子能撑多久
你会待多长时间	你会待多长时间
你有多少朋友	你有多少朋友
汤姆吃老多少橘子	汤姆吃了多少橘子
你有多少支球拍	你有多少支球拍
暑假过得如何	暑假过得如何
快点请帮帮我	快点请帮帮我
我登广告卖我的车	我登广告卖我的车
我的数学不好	我的数学不好
我是该队的领导者	我是该队的领导者
我请我父亲帮忙	我请我父亲帮忙
我向我父亲求助	我向我父亲求助
我让她等老一分钟	我让她等了一分钟
我请她等一会儿	我请她等一会儿
我参加帆船社	我参加帆船社
我买老两袋爆米花	我买了两袋爆米花
我买老两条面包	我买了两条面包
我一天刷两次牙	我一天刷两次牙
我来日本看京都	我来日本看京都
我会教你啷个开车	我会教你怎么开车
我买不起一辆车	我买不起一辆车
我的中文说得不好	我的中文说得不好
我两天前感冒老	我两天前感冒了
我不是想打扰你	我不是想打扰你
我不想这种事发生	我不想这种事发生
我没料到会有问题	我没料到会有问题
我身上莫得钱	我身上没有钱
我莫得现在的地址	我没有现在的地址
我现在莫得地址	我现在没有地址
我不喜欢上学	我不喜欢上学
我没看见啥子弹孔	我没看见什么弹孔
我不想被他感动	我不想被他感动
我不想晒黑	我不想晒黑
我不想切学校	我不想去学校
我不想再玩老	我不想再玩了
我已经不带眼镜老	我已经不带眼镜了
我不担心风险	我不担心风险
我跟着鹿的踪迹	我跟着鹿的踪迹
我戒烟一年老	我戒烟一年了
我给你个好东西	我给你个好东西
我今天玩得很开心	我今天玩得很开心
第二天我的腿很酸	第二天我的腿很酸
我觉得他是对的	我觉得他是对的
我今天的食慾很好	我今天的食慾很好
我胃痛医生	我胃痛医生
我百分之百相信你	我百分之百相信你
我绝对信任你	我绝对信任你
我的车里有伞	我的车里有伞
我没朋友帮我	我没朋友帮我
我有些东西要给你	我有些东西要给你
我有事要告诉你	我有事要告诉你
我有三百万美圆	我有三百万美圆
昨天我帮老我爸爸	昨天我帮了我爸爸
我希望这是对的	我希望这是对的
我很老解这地方	我很了解这地方
我知道你比我有钱	我知道你比我有钱
我住在国外十年老	我住在国外十年了
我爱看足球	我爱看足球
我可能把钥匙忘老	我可能把钥匙忘了
我昨天切见他老	我昨天去见他了
放学后我打老网球	放学后我打了网球
我两年前戒菸老	我两年前戒菸了
我真的不需要帮助	我真的不需要帮助
我收到老她的来信	我收到了她的来信
我不该对你说谎	我不该对你说谎
我开始想起汤姆	我开始想起汤姆
我学习英语和日语	我学习英语和日语
我认为汤姆会高兴	我认为汤姆会高兴
我觉得今天会很热	我觉得今天会很热
我想她会和他离婚	我想她会和他离婚
我觉得你说老啥子	我觉得你说了什么
我以前是护林人	我以前是护林人
我等她好长时间老	我等她好长时间了
我想再切那里一次	我想再去那里一次
我当时是学生	我当时是学生
我怕我可能迟到老	我怕我可能迟到了
我独自待在教室里	我独自待在教室里
我一直都擅长英文	我一直都擅长英文
我切老河里游泳	我去了河里游泳
我将在家学习英语	我将在家学习英语
但愿我会讲英语	但愿我会讲英语
我希望我不必工作	我希望我不必工作
我希望雨会停	我希望雨会停
我不会让你做那事	我不会让你做那事
我想要订房	我想要订房
我想要出席排队	我想要出席排队
我想在五点前到家	我想在五点前到家
我想住在纽约	我想住在纽约
九月我将满十六岁	九月我将满十六岁
我会给你开个药方	我会给你开个药方
我明天把它寄给你	我明天把它寄给你
我会深思熟虑	我会深思熟虑
我怕我冒犯老你	我怕我冒犯了你
我受够老这天气	我受够了这天气
我要睡老晚安	我要睡了晚安
我要切换我的衬衫	我要去换我的衬衫
我处在绝境	我处在绝境
我周日从不在家	我周日从不在家
我新接触这种工作	我新接触这种工作
我莫得反对你	我没有反对你
我在回波士顿	我在回波士顿
我真怕蜘蛛	我真怕蜘蛛
我受够吃快餐老	我受够吃快餐了
我是这船的船长	我是这船的船长
我习惯早起	我习惯早起
我已经吃过早饭老	我已经吃过早饭了
我一直想见你	我一直想见你
我要学很多	我要学很多
我的脚起水泡老	我的脚起水泡了
我刚吃完老早饭	我刚吃完了早饭
工业发展迅速	工业发展迅速
利率还是低	利率还是低
她是个女程序员吗	她是个女程序员吗
她是个程序媛吗	她是个程序媛吗
这是火车站吗	这是火车站吗
它跟我没关系	它跟我没关系
读这本书很容易	读这本书很容易
这本书很容易读	这本书很容易读
训练狗是不容易的	训练狗是不容易的
帮助是我们的义务	帮助是我们的义务
这对我没啥子差别	这对我没什么差别
无论如何说不通	无论如何说不通
下午可能会下雪	下午可能会下雪
这片区域很少下雪	这片区域很少下雪
这是个静谧的冬夜	这是个静谧的冬夜
一点也不好玩	一点也不好玩
已经是时候回切老	已经是时候回去了
很明显地你错老	很明显地你错了
这尽够汤姆的	这尽够汤姆的
跟他吵没用	跟他吵没用
显然地她生病老	显然地她生病了
它在我的舌尖上	它在我的舌尖上
据说她爱他	据说她爱他
日本以富士山闻名	日本以富士山闻名
希望你用不着它	希望你用不着它
伦敦以雾著名	伦敦以雾著名
玛丽到老医院	玛丽到了医院
玛丽很容易发脾气	玛丽很容易发脾气
请把帐单给我好吗	请把帐单给我好吗
也许他不会成名	也许他不会成名
我男朋友是个记者	我男朋友是个记者
我的字典非常有用	我的字典非常有用
我父亲在工厂工作	我父亲在工厂工作
我的朋友不打网球	我的朋友不打网球
我的祖父早起	我的祖父早起
我的房子莫得顶	我的房子没有顶
我家离火车站很近	我家离火车站很近
我儿子在刷牙	我儿子在刷牙
不谢谢我饱老	不谢谢我饱了
现在你想看甚么	现在你想看甚么
老人们很早就起床	老人们很早就起床
我们家有三个卧室	我们家有三个卧室
人要爱他人	人要爱他人
请帮我叫宾馆保安	请帮我叫宾馆保安
进来之前请敲门	进来之前请敲门
请不要客气	请不要客气
请穿上这些拖鞋	请穿上这些拖鞋
请把那些椅子放好	请把那些椅子放好
请记住他说的话	请记住他说的话
最近物价已经下降	最近物价已经下降
在花瓶里装些水	在花瓶里装些水
看书很有意思	看书很有意思
别忘老刷牙	别忘了刷牙
记得要切寄这封信	记得要去寄这封信
代我向你父亲问好	代我向你父亲问好
她爱慕她哥哥	她爱慕她哥哥
她还不会骑脚踏车	她还不会骑脚踏车
她莫得敌人	她没有敌人
她一个朋友都莫得	她一个朋友都没有
她每天挣30美元	她每天挣30美元
她生下老一个男婴	她生下了一个男婴
她生老双胞胎女儿	她生了双胞胎女儿
她手上有一朵花	她手上有一朵花
她昨天自杀老	她昨天自杀了
她喜欢听音乐	她喜欢听音乐
她用苹果做老果酱	她用苹果做了果酱
她可能比你高	她可能比你高
她确实喜欢动物	她确实喜欢动物
她在一棵树下坐着	她在一棵树下坐着
她易患感冒	她易患感冒
一部分钱被偷老	一部分钱被偷了
有人刚才在这里	有人刚才在这里
打铁趁热	打铁趁热
告诉我啷个玩游戏	告诉我怎么玩游戏
谢谢您的关注	谢谢您的关注
感谢您的回电	感谢您的回电
谢谢您的迅速回复	谢谢您的迅速回复
那辆汽车真的很贵	那辆汽车真的很贵
这应证老我的想法	这应证了我的想法
那是因为妳是女生	那是因为妳是女生
那不关你的事	那不关你的事
那不是猫那是狗	那不是猫那是狗
助手拿老钱	助手拿了钱
公车晚老十分钟	公车晚了十分钟
这辆车陷在泥里老	这辆车陷在泥里了
猫看着鱼	猫看着鱼
会议在五点钟结束	会议在五点钟结束
生活费升高老	生活费升高了
猎人射杀老狐狸	猎人射杀了狐狸
树叶掉在地上	树叶掉在地上
这人因谋杀被通缉	这人因谋杀被通缉
会议接近老尾声	会议接近了尾声
猴子爬上老树	猴子爬上了树
昨晚月亮满老	昨晚月亮满了
这位老人死于饥饿	这位老人死于饥饿
老人独自生活	老人独自生活
这位老人饿死老	这位老人饿死了
海盗们上老船	海盗们上了船
士兵给老我水	士兵给了我水
我对这个单词不熟	我对这个单词不熟
你的袜子上有个洞	你的袜子上有个洞
有一个大型超市	有一个大型超市
只有一条浴巾	只有一条浴巾
燃料短缺	燃料短缺
房间里莫得人	房间里没有人
除老我莫得人离开	除了我没有人离开
一个人影也看不到	一个人影也看不到
莫得椅子坐	没有椅子坐
莫得必要道歉	没有必要道歉
他们比我们高得多	他们比我们高得多
他们在谈音乐	他们在谈音乐
他们买老一盒曲奇	他们买了一盒曲奇
他们忘老锁门	他们忘了锁门
他们一定在等你	他们一定在等你
这本书很难读	这本书很难读
这车容易开	这车容易开
这辆车是最新款	这辆车是最新款
这条连衣裙很便宜	这条连衣裙很便宜
这个问题很简单	这个问题很简单
这真的是个好天气	这真的是个好天气
这个房间有空调	这个房间有空调
这衬衫要十元	这衬衫要十元
有三票反对这主意	有三票反对这主意
汤姆唱歌总跑调	汤姆唱歌总跑调
汤姆和玛丽很饿	汤姆和玛丽很饿
汤姆换上制服	汤姆换上制服
汤姆不能自已	汤姆不能自已
汤姆甚么也没说	汤姆甚么也没说
汤姆不关心钱	汤姆不关心钱
汤姆不需要谢我	汤姆不需要谢我
汤姆并不信任警察	汤姆并不信任警察
汤姆不想一个人走	汤姆不想一个人走
Tom有很多女友	Tom有很多女友
汤姆要考虑很多	汤姆要考虑很多
汤姆整天都在开车	汤姆整天都在开车
汤姆一直在说谎	汤姆一直在说谎
汤姆最近变瘦老	汤姆最近变瘦了
汤姆从没进过监狱	汤姆从没进过监狱
汤姆是玛丽的前夫	汤姆是玛丽的前夫
汤姆是个高中生	汤姆是个高中生
汤姆在找新工作	汤姆在找新工作
汤姆现在在休息	汤姆现在在休息
汤姆对甚么都不怕	汤姆对甚么都不怕
汤姆亲老玛丽脸颊	汤姆亲了玛丽脸颊
汤姆需要很小心	汤姆需要很小心
汤姆给车盖上套	汤姆给车盖上套
汤姆告诉我他想赢	汤姆告诉我他想赢
汤姆在爆炸中受伤	汤姆在爆炸中受伤
汤姆的生日是昨天	汤姆的生日是昨天
下一个街角左转	下一个街角左转
不幸的是她不在	不幸的是她不在
饭前要洗手	饭前要洗手
我们非常需要食物	我们非常需要食物
我们不切度假	我们不去度假
我们止不住哭泣	我们止不住哭泣
我们莫得别的选择	我们没有别的选择
我们很快修好老	我们很快修好了
伦敦起老大雾	伦敦起了大雾
昨天天气很糟	昨天天气很糟
我们有特殊联系	我们有特殊联系
我们必须止血	我们必须止血
我们住在美国	我们住在美国
我们必须遵守规则	我们必须遵守规则
我们一起切野餐老	我们一起去野餐了
我们莫得笑话你	我们没有笑话你
我们明天会有客人	我们明天会有客人
我们明天上午开始	我们明天上午开始
我们明天讨论它	我们明天讨论它
我的责任是啥子	我的责任是什么
你在担心啥子呢	你在担心什么呢
她在店里买老啥子	她在店里买了什么
你为啥子切京都	你为什么去京都
这个花叫啥子名字	这个花叫什么名字
你的袋子里有啥子	你的袋子里有什么
我们切滑雪啷个样	我们去滑雪怎么样
你的妹妹唸几年级	你的妹妹唸几年级
我对汤姆做老啥子	我对汤姆做了什么
你看到啥子拿啥子	你看到什么拿什么
这歌叫啥子名字	这歌叫什么名字
这该是甚么意思	这该是甚么意思
你最喜欢啥子气候	你最喜欢什么气候
上周日你切哪儿老	上周日你去哪儿了
结帐柜台在哪里	结帐柜台在哪里
最近的药房在哪里	最近的药房在哪里
下一列火车切哪里	下一列火车去哪里
你想睡哪张床	你想睡哪张床
哪条路通往市政厅	哪条路通往市政厅
你在找哪个汤姆	你在找谁汤姆
啷个这么多人	怎么这么多人
你为甚么不锁门	你为甚么不锁门
为啥子人们会自杀	为什么人们会自杀
为啥子你不吃蔬菜	为什么你不吃蔬菜
9点可以吗	9点可以吗
你要再来颗苹果吗	你要再来颗苹果吗
您想要茶还是咖啡	您想要茶还是咖啡
你想一起切吗	你想一起去吗
你很适合这份工作	你很适合这份工作
你想切哪里都可以	你想去哪里都可以
莫得水你不能生活	没有水你不能生活
你啥子都没跟他说	你什么都没跟他说
你莫得时间老	你没有时间了
你找错老零钱给我	你找错了零钱给我
你无权那么做	你无权那么做
你必须遵守规则	你必须遵守规则
你知道我想听甚么	你知道我想听甚么
你不如跟我一起来	你不如跟我一起来
你得留意一哈	你得留意一下
你该剪头发老	你该剪头发了
你该理发老	你该理发了
你应该信守诺言	你应该信守诺言
你该听你父母的话	你该听你父母的话
你昨天应该来的	你昨天应该来的
你应该保密的	你应该保密的
你想保持匿名身份	你想保持匿名身份
你最好立刻回家	你最好立刻回家
你明天切学校	你明天去学校
你必须马上开始	你必须马上开始
我走老你会想我	我走了你会想我
你大约遅老三天	你大约遅了三天
你总是批评我	你总是批评我
你就是荒唐	你就是荒唐
你哥哥不会买它	你哥哥不会买它
你的笔比我的好	你的笔比我的好
医生立刻被请来老	医生立刻被请来了
一条狗被卡车碾过	一条狗被卡车碾过
他们都是好老师	他们都是好老师
你是高中生吗	你是高中生吗
你下午有空吗	你下午有空吗
你明晚有空吗	你明晚有空吗
你打算帮助他们吗	你打算帮助他们吗
你住在这家旅馆吗	你住在这家旅馆吗
算数处理数字	算数处理数字
她的双頬红老	她的双頬红了
清理镜子上的灰尘	清理镜子上的灰尘
你可以关灯吗	你可以关灯吗
你那天切老伦敦吗	你那天去了伦敦吗
你让窗户开着吗	你让窗户开着吗
你昨天打网球老吗	你昨天打网球了吗
您参观过东京塔吗	您参观过东京塔吗
我必须立刻做吗	我必须立刻做吗
您有日本啤酒吗	您有日本啤酒吗
你有医疗保险吗	你有医疗保险吗
你介意打开电视吗	你介意打开电视吗
你要我煮咖啡吗	你要我煮咖啡吗
你想吃点午饭吗	你想吃点午饭吗
这辆公车切海滩吗	这辆公车去海滩吗
别犯傻我能做到	别犯傻我能做到
别麻烦保安老	别麻烦保安了
不要插手我的事	不要插手我的事
不要让水一直流	不要让水一直流
别老依赖别人	别老依赖别人
别跟我说你不知道	别跟我说你不知道
趁热喝你的汤	趁热喝你的汤
英语很难学	英语很难学
请系好安全带	请系好安全带
你已经吃晚饭老吗	你已经吃晚饭了吗
你切过美国吗	你去过美国吗
你全都给汤姆老吗	你全都给汤姆了吗
他昨天抵达东京	他昨天抵达东京
他昨天到老东京	他昨天到了东京
他要老水喝	他要了水喝
他问我买老啥子	他问我买了什么
他参加摄影社	他参加摄影社
他一年来东京一次	他一年来东京一次
他抱怨这个噪音	他抱怨这个噪音
他继续看书	他继续看书
他给老她一个忠告	他给了她一个忠告
他给这只狗一些肉	他给这只狗一些肉
他银行里有点钱	他银行里有点钱
他是一位专职牙医	他是一位专职牙医
他会弹吉他	他会弹吉他
他总是要钱	他总是要钱
他比任何人都好	他比任何人都好
他缺乏常识	他缺乏常识
他可能又迟到老	他可能又迟到了
他比他的弟弟高	他比他的弟弟高
他习惯于作演说	他习惯于作演说
他敲老敲紧闭的门	他敲了敲紧闭的门
他知道啷个玩棒球	他知道怎么玩棒球
他七点钟切学校	他七点钟去学校
他就住在马路对面	他就住在马路对面
他搬到老我家附近	他搬到了我家附近
他晚饭经常吃鱼	他晚饭经常吃鱼
他常常载我切兜风	他常常载我去兜风
他画老一幅狗的画	他画了一幅狗的画
他参加辩论	他参加辩论
他停下来抽根烟	他停下来抽根烟
他整天打网球	他整天打网球
他小提琴拉得很好	他小提琴拉得很好
他不遗馀力帮助我	他不遗馀力帮助我
他在大学修读历史	他在大学修读历史
子承父业	子承父业
他以为啥子都知道	他以为什么都知道
他忙于做功课	他忙于做功课
他当时一个人在家	他当时一个人在家
他昨晚在看电视	他昨晚在看电视
他愿意帮助别人	他愿意帮助别人
他星期一切老纽约	他星期一去了纽约
他会继承王位	他会继承王位
他五点左右会回来	他五点左右会回来
他是我哥哥的朋友	他是我哥哥的朋友
他是个成功的商人	他是个成功的商人
他穿着上很不讲究	他穿着上很不讲究
她的想法比你的好	她的想法比你的好
她的大女儿结婚老	她的大女儿结婚了
他的建议不算啥子	他的建议不算什么
出切吃午饭怎样	出去吃午饭怎样
切看电影怎样	去看电影怎样
你打算啷个回家	你打算怎么回家
你啷个画这幅画	你怎么画这幅画
你在国外多久老	你在国外多久了
雨会下多久	雨会下多久
我们要等多久	我们要等多久
你会在日本多久	你会在日本多久
你有几个小孩	你有几个小孩
有多少人知道我们	有多少人知道我们
你买老多少张图画	你买了多少张图画
你买老多少张照片	你买了多少张照片
这副眼镜多少钱	这副眼镜多少钱
你欠汤姆多少钱	你欠汤姆多少钱
你多常造访京都	你多常造访京都
明年你会是几岁	明年你会是几岁
昨天的会议啷个样	昨天的会议怎么样
我们啷个保护自己	我们怎么保护自己
您的牛排要几分熟	您的牛排要几分熟
纽约的天气如何	纽约的天气如何
我建议她九点前来	我建议她九点前来
我开始记起来老	我开始记起来了
今天下午我会外出	今天下午我会外出
我将主修法文	我将主修法文
我正在找一个助手	我正在找一个助手
我在考虑出国	我在考虑出国
我感谢您的合作	我感谢您的合作
我要求汤姆关门	我要求汤姆关门
我是游泳社的成员	我是游泳社的成员
我参加游泳社	我参加游泳社
我两年前来日本	我两年前来日本
我看你擅长做这事	我看你擅长做这事
我付不起这么多钱	我付不起这么多钱
我受不老他的视线	我受不了他的视线
我无法再做下切老	我无法再做下去了
我不那么会打网球	我不那么会打网球
昨天我钓老三条鱼	昨天我钓了三条鱼
我决定不切欧洲老	我决定不去欧洲了
我决定不学法语	我决定不学法语
我做老很蠢的事	我做了很蠢的事
起初我不相信他	起初我不相信他
我没听到您的姓	我没听到您的姓
我不知道你的计画	我不知道你的计画
我不知道她结婚老	我不知道她结婚了
我不想很早起床	我不想很早起床
我没想吓唬你	我没想吓唬你
我在放学后做作业	我在放学后做作业
我再也不相信他老	我再也不相信他了
我完全不要牛奶	我完全不要牛奶
我不同意你的决定	我不同意你的决定
我身上莫得很多钱	我身上没有很多钱
我没时间阅读	我没时间阅读
我不用打扫房间	我不用打扫房间
我特别不喜欢她	我特别不喜欢她
我觉得他不能帮你	我觉得他不能帮你
我不认为他是对的	我不认为他是对的
我觉得这不是真的	我觉得这不是真的
我一点法语都不懂	我一点法语都不懂
我现在不想吃午饭	我现在不想吃午饭
我不想不通过考试	我不想不通过考试
我不想挂科	我不想挂科
我不想不及格	我不想不及格
我不想落榜	我不想落榜
我不想考试失败	我不想考试失败
我不想错过考试	我不想错过考试
我每天早上吃早餐	我每天早上吃早餐
我每周吃肉三次	我每周吃肉三次
我现在想洗澡	我现在想洗澡
我现在想要散步	我现在想要散步
我常常觉得悲伤	我常常觉得悲伤
我不时地觉得难过	我不时地觉得难过
我每隔一天切购物	我每隔一天去购物
我的英文成绩很好	我的英文成绩很好
我早上很早起床	我早上很早起床
我昨晚睡得很好	我昨晚睡得很好
我学日语有困难	我学日语有困难
我无从知道	我无从知道
我有些事	我有些事
我得切医院	我得去医院
我必须再考一次试	我必须再考一次试
我还莫得下定决心	我还没有下定决心
我还莫得拿定主意	我还没有拿定主意
我听到电话响老	我听到电话响了
我希望你很健康	我希望你很健康
我想你快点好	我想你快点好
我只是不想失切你	我只是不想失去你
我只想跟汤姆说话	我只想跟汤姆说话
我对纽约老如指掌	我对纽约了如指掌
我知道他切老伦敦	我知道他去了伦敦
我知道她一直很忙	我知道她一直很忙
我知道你尽力老	我知道你尽力了
我知道你要说不	我知道你要说不
我知道你不舒服	我知道你不舒服
我和你哥哥很熟	我和你哥哥很熟
我喜欢咖啡胜过茶	我喜欢咖啡胜过茶
我想要听流行音乐	我想要听流行音乐
我喜欢听收音机	我喜欢听收音机
我喜欢听广播	我喜欢听广播
我喜欢在乡间散步	我喜欢在乡间散步
我要他提行李箱	我要他提行李箱
我在深夜遇见老她	我在深夜遇见了她
我经常和他切钓鱼	我经常和他去钓鱼
我只想知道事实	我只想知道事实
我只想做好事	我只想做好事
我偶尔打网球	我偶尔打网球
我和我爸爸玩接球	我和我爸爸玩接球
我记得给老他钥匙	我记得给了他钥匙
我记得寄老信	我记得寄了信
我记得以前见到你	我记得以前见到你
我看见远处有灯光	我看见远处有灯光
我应该拿那些钱的	我应该拿那些钱的
我做事该果断	我做事该果断
我该早点回家	我该早点回家
我在箱根渡假	我在箱根渡假
我订阅老两份报纸	我订阅了两份报纸
我建议她一个人切	我建议她一个人去
我每两天洗一次澡	我每两天洗一次澡
我照顾我的爷爷	我照顾我的爷爷
我想我找到答案老	我想我找到答案了
我带孩子们切上学	我带孩子们去上学
我试图改变话题	我试图改变话题
我经常搭公车上学	我经常搭公车上学
我等老他一整天	我等了他一整天
我要他弹吉他	我要他弹吉他
我想喝点热的饮料	我想喝点热的饮料
我想要吃甜的东西	我想要吃甜的东西
我想买条裤子	我想买条裤子
我想买这本字典	我想买这本字典
我想先吃点蛋糕	我想先吃点蛋糕
我明年想切国外	我明年想去国外
我要你把窗户打开	我要你把窗户打开
我确定你会来	我确定你会来
我被这情景吓到老	我被这情景吓到了
我出城度假老	我出城度假了
我和家人切露营	我和家人去露营
我切公园散老步	我去公园散了步
上周六我切购物	上周六我去购物
我搭计程车切机场	我搭计程车去机场
我今天下午会很忙	我今天下午会很忙
我十分钟后有空	我十分钟后有空
我下次会早点来	我下次会早点来
我明天会切美国	我明天会去美国
我会谈谈它	我会谈谈它
我会让你看照片	我会让你看照片
但愿我长高一点	但愿我长高一点
我希望汤姆走开	我希望汤姆走开
我希望汤姆回家	我希望汤姆回家
我想要成为诗人	我想要成为诗人
我想知道她的名字	我想知道她的名字
我想有一天切国外	我想有一天去国外
我想试穿这件衣服	我想试穿这件衣服
我宁愿你待在家里	我宁愿你待在家里
我会在七点钟回来	我会在七点钟回来
我明天带给你	我明天带给你
我会切你家接你	我会去你家接你
我对这气候习惯老	我对这气候习惯了
我其实做得很好	我其实做得很好
我问你你在想啥子	我问你你在想什么
我下周要切欧洲	我下周要去欧洲
我下个月要切巴黎	我下个月要去巴黎
我切弄饮料给你	我去弄饮料给你
我最近听说老不少	我最近听说了不少
我不是很擅长游泳	我不是很擅长游泳
我对此真不高兴	我对此真不高兴
我确定他会生气	我确定他会生气
我厌倦吃快餐老	我厌倦吃快餐了
我习惯整夜工作	我习惯整夜工作
我一直以您为荣	我一直以您为荣
我一直为您骄傲	我一直为您骄傲
我一直都想做	我一直都想做
我控制住老	我控制住了
我听够你的谎话老	我听够你的谎话了
我从没低估汤姆	我从没低估汤姆
汤姆及时地来爱她	汤姆及时地来爱她
印度是发展中国家	印度是发展中国家
我跟汤姆外出行吗	我跟汤姆外出行吗
吃蟑螂安全吗	吃蟑螂安全吗
这附近有医院吗	这附近有医院吗
天气真是太好老	天气真是太好了
这不是汤姆要的吗	这不是汤姆要的吗
一切都取决于天气	一切都取决于天气
你做啥子都无所谓	你做什么都无所谓
它发出巨响爆炸老	它发出巨响爆炸了
跟你莫得关系	跟你没有关系
不关你的事	不关你的事
说英语很有趣	说英语很有趣
很快就要下雨老	很快就要下雨了
这几乎不值得讨论	这几乎不值得讨论
明天有可能会下雨	明天有可能会下雨
和她争辩是没用的	和她争辩是没用的
再问他也没用	再问他也没用
跟他说话没用	跟他说话没用
嘲笑别人是无礼的	嘲笑别人是无礼的
太暗老我无法读	太暗了我无法读
玩牌作弊是错误的	玩牌作弊是错误的
今天早上很冷	今天早上很冷
昨晚不是很热	昨晚不是很热
不久就要吃正餐老	不久就要吃正餐了
它的大小就像鸡蛋	它的大小就像鸡蛋
已经过老十点钟老	已经过了十点钟了
我表上是4点	我表上是4点
骑摩托车很有趣	骑摩托车很有趣
现在不可能出切	现在不可能出去
它对你的眼睛有害	它对你的眼睛有害
车辆靠左行驶	车辆靠左行驶
学习英语很辛苦	学习英语很辛苦
让你叔叔想一想	让你叔叔想一想
从这个问题开始吧	从这个问题开始吧
我们休息一会儿吧	我们休息一会儿吧
切纽约旅行吧	去纽约旅行吧
切纽约吧	去纽约吧
躺下来休息一会儿	躺下来休息一会儿
查查你的字典	查查你的字典
爱让世界转动	爱让世界转动
玛丽手上有一朵花	玛丽手上有一朵花
玛丽下楼到厨房	玛丽下楼到厨房
请给我一张路线图	请给我一张路线图
我可以喝点东西吗	我可以喝点东西吗
可能你应该放弃	可能你应该放弃
我的老板要我加班	我的老板要我加班
我的父亲死于肺癌	我的父亲死于肺癌
父亲让我洗汽车	父亲让我洗汽车
我父亲喜欢浓咖啡	我父亲喜欢浓咖啡
我爷爷是个木匠	我爷爷是个木匠
我的手和脚都肿老	我的手和脚都肿了
我的嗜好是集邮	我的嗜好是集邮
我的房子靠近公园	我的房子靠近公园
我妈妈的厨艺很好	我妈妈的厨艺很好
我妈妈很喜欢茶	我妈妈很喜欢茶
我的母亲从不早起	我的母亲从不早起
妈妈带我切公园	妈妈带我去公园
我侄子对鸡蛋过敏	我侄子对鸡蛋过敏
我哥哥是一名教师	我哥哥是一名教师
我妹妹比你矮	我妹妹比你矮
我的表慢老五分钟	我的表慢了五分钟
我全家来自波士顿	我全家来自波士顿
没人叫你小偷	没人叫你小偷
没人死在火里	没人死在火里
也许明天会下雨	也许明天会下雨
请安静地关门	请安静地关门
请每天喂一哈狗	请每天喂一下狗
请你给我一杯水	请你给我一杯水
请告诉我你的想法	请告诉我你的想法
请等到我回来	请等到我回来
今年销售会翻番	今年销售会翻番
她总是信守承诺	她总是信守承诺
她企图自杀	她企图自杀
她买老两双袜子	她买了两双袜子
她会讲三种语言	她会讲三种语言
她离不开她的车	她离不开她的车
莫得车她做不老事	没有车她做不了事
她自己煮晚餐老	她自己煮晚餐了
她莫得常到户外	她没有常到户外
她终于到达老酒店	她终于到达了酒店
她忘老寄信	她忘了寄信
她屈服于诱惑老	她屈服于诱惑了
她给老我这个光碟	她给了我这个光碟
她松老一口气	她松了一口气
她脾气有点坏	她脾气有点坏
她一直住在小樽	她一直住在小樽
她的笔迹很美	她的笔迹很美
她沉迷于摇滚乐	她沉迷于摇滚乐
她今晚举行派对	她今晚举行派对
她正在给婴儿洗澡	她正在给婴儿洗澡
她将切千叶球场	她将去千叶球场
她擅长打网球	她擅长打网球
她嫁给老美国人	她嫁给了美国人
她不害怕任何东西	她不害怕任何东西
她中文有进步	她中文有进步
她很漂亮不是吗	她很漂亮不是吗
她在处理问题	她在处理问题
她清晨离开老	她清晨离开了
她昨天离开切伦敦	她昨天离开去伦敦
她十分钟前离家	她十分钟前离家
她喜欢各种运动	她喜欢各种运动
她就住在我们对面	她就住在我们对面
她照顾孩子们	她照顾孩子们
她很快地打开老信	她很快地打开了信
她昨天来见我老	她昨天来见我了
她放学后打网球	她放学后打网球
她钢琴弹得很好	她钢琴弹得很好
她假装是学生	她假装是学生
她把钱放在银行里	她把钱放在银行里
她说他很英俊	她说他很英俊
她独自留在家里	她独自留在家里
她在那里留老一会	她在那里留了一会
她每天学习英语	她每天学习英语
她照顾我的孩子	她照顾我的孩子
她照顾孩子	她照顾孩子
她每两天探访我们	她每两天探访我们
她想参加这个派对	她想参加这个派对
她迷上老视频	她迷上了视频
她被任命为主席	她被任命为主席
她觉得有点累老	她觉得有点累了
她上个月在美国	她上个月在美国
她经常上学迟到	她经常上学迟到
她昨天卧病在床	她昨天卧病在床
她从伦敦切老巴黎	她从伦敦去了巴黎
她出切买些食物老	她出去买些食物了
她切老高须诊所	她去了高须诊所
她跟他切公园老	她跟他去公园了
她会是他的好妻子	她会是他的好妻子
她是个中年胖女人	她是个中年胖女人
你不该还在床上吗	你不该还在床上吗
有些人相信鬼	有些人相信鬼
有人正在弹钢琴	有人正在弹钢琴
这里有些事真怪	这里有些事真怪
抱歉我没钱	抱歉我没钱
说英语很难	说英语很难
把邮票贴在信封上	把邮票贴在信封上
别说话听我说	别说话听我说
京都的夏天很热	京都的夏天很热
小心不要着凉	小心不要着凉
感谢您的邀请	感谢您的邀请
那座桥很漂亮	那座桥很漂亮
那是场精彩的会议	那是场精彩的会议
塞纳河穿越老巴黎	塞纳河穿越了巴黎
这班飞机准时起飞	这班飞机准时起飞
军队强迫他辞职	军队强迫他辞职
巴士早老两分钟	巴士早了两分钟
日本的首都是东京	日本的首都是东京
这车不值得修老	这车不值得修了
猫从树篱穿过切	猫从树篱穿过去
孩子们出切玩老	孩子们出去玩了
云越来越黑	云越来越黑
音乐会即将开始	音乐会即将开始
狗对着邮差叫	狗对着邮差叫
这条裙子很适合你	这条裙子很适合你
这实验是成功的	这实验是成功的
客人们在厨房里	客人们在厨房里
房子现在没被占住	房子现在没被占住
这信是汤姆写的	这信是汤姆写的
噪声吓到老婴儿	噪声吓到了婴儿
穷人无亲戚	穷人无亲戚
蛋的价格正在上涨	蛋的价格正在上涨
这个机器人失控老	这个机器人失控了
太阳升出老地平线	太阳升出了地平线
小镇充满老活力	小镇充满了活力
火车6点出发	火车6点出发
这堵墙长三十码	这堵墙长三十码
桌上的手表是我的	桌上的手表是我的
天气非常寒冷	天气非常寒冷
厨房里有一只猫	厨房里有一只猫
书桌下有一只猫	书桌下有一只猫
书桌上有一个苹果	书桌上有一个苹果
看不到任何一棵树	看不到任何一棵树
这个桶子上有个洞	这个桶子上有个洞
借口是没用的	借口是没用的
一刻也不浪费	一刻也不浪费
还是看不见尽头	还是看不见尽头
这些容器是密封的	这些容器是密封的
这些画很美	这些画很美
这些鞋不合我的脚	这些鞋不合我的脚
他们都是大学生	他们都是大学生
他们是高中生	他们是高中生
他们肯定会相恋的	他们肯定会相恋的
他们帮他切加拿大	他们帮他去加拿大
他们坚持让他走	他们坚持让他走
他们一定是犯错老	他们一定是犯错了
据说他很富有	据说他很富有
他们一直闹笑话	他们一直闹笑话
他们只在白天工作	他们只在白天工作
他们设法控制你	他们设法控制你
这本书充满老错误	这本书充满了错误
这本书很有趣	这本书很有趣
这本书不值得一读	这本书不值得一读
这是我能为您做的	这是我能为您做的
这值100万日元	这值100万日元
今天我很忧郁	今天我很忧郁
汤姆做老许多大事	汤姆做了许多大事
汤姆莫得参加会议	汤姆没有参加会议
汤姆昨天没切那里	汤姆昨天没去那里
汤姆没脱鞋	汤姆没脱鞋
汤姆没穿鞋	汤姆没穿鞋
汤姆不想失切玛丽	汤姆不想失去玛丽
汤姆忘老做作业	汤姆忘了做作业
汤姆对孩子们生气	汤姆对孩子们生气
汤姆绝莫得敌人	汤姆绝没有敌人
汤姆还有想说的事	汤姆还有想说的事
汤姆必须马上切做	汤姆必须马上去做
汤姆要竞选市长	汤姆要竞选市长
汤姆在找工作	汤姆在找工作
汤姆搭公车切市区	汤姆搭公车去市区
汤姆正在拉小提琴	汤姆正在拉小提琴
汤姆在花园里站着	汤姆在花园里站着
汤姆比他的母亲高	汤姆比他的母亲高
汤姆担心他的安全	汤姆担心他的安全
汤姆找到老新工作	汤姆找到了新工作
汤姆需要换换风景	汤姆需要换换风景
汤姆说他丢老钥匙	汤姆说他丢了钥匙
汤姆说它十分重要	汤姆说它十分重要
汤姆想切澳大利亚	汤姆想去澳大利亚
汤姆明天回家	汤姆明天回家
树不会长在草原上	树不会长在草原上
在下一个转角右转	在下一个转角右转
进食前先洗手	进食前先洗手
看着他并跟着他做	看着他并跟着他做
水对人是很重要的	水对人是很重要的
我们两个同班	我们两个同班
我们待在舅舅家	我们待在舅舅家
我们偶尔切钓鱼	我们偶尔去钓鱼
昨天下大雨	昨天下大雨
我们不能嘲笑穷人	我们不能嘲笑穷人
我们切海边游泳	我们去海边游泳
我们切河里游泳	我们去河里游泳
我们准备刷墙	我们准备刷墙
我们还是有点疑惑	我们还是有点疑惑
我们决定不开除你	我们决定不开除你
今晚的天气不错	今晚的天气不错
花园里杂草丛生	花园里杂草丛生
你在那里干啥子	你在那里干什么
你早餐吃啥子	你早餐吃什么
你觉得我在干吗呢	你觉得我在干吗呢
要是有东西坏老呢	要是有东西坏了呢
复水难收	复水难收
啥子时候开始登机	什么时候开始登机
演出啥子时候开始	演出什么时候开始
你表上是几点	你表上是几点
我该几点切接你	我该几点去接你
今天天气啷个样	今天天气怎么样
你啥子时候方便	你什么时候方便
你切哪里度假老	你去哪里度假了
你今天想切哪儿呀	你今天想去哪儿呀
您在哪儿看电视	您在哪儿看电视
日本大使馆在哪里	日本大使馆在哪里
最近的药店在哪里	最近的药店在哪里
今晚哪个发言	今晚谁发言
信是写给哪个的	信是写给谁的
为啥子不尝尝寿司	为什么不尝尝寿司
你要我帮你吗	你要我帮你吗
你想再来些牛肉吗	你想再来些牛肉吗
你想再喝些啤酒吗	你想再喝些啤酒吗
你想再来些蛋糕吗	你想再来些蛋糕吗
你和他都很友好	你和他都很友好
你今天不必读书	你今天不必读书
你的手帕掉老	你的手帕掉了
你看起来有困惑	你看起来有困惑
您必须弥补损失	您必须弥补损失
你必须注意他	你必须注意他
你需要现在就回家	你需要现在就回家
你应该更明智一点	你应该更明智一点
你应该要更努力的	你应该要更努力的
您该告诉他真相	您该告诉他真相
你该告诉他真相	你该告诉他真相
你不该一个人来	你不该一个人来
你不应该切那里的	你不应该去那里的
你现在最好回家	你现在最好回家
你滑雪比我好	你滑雪比我好
你并不满意对吧	你并不满意对吧
你病老该休息老	你病了该休息了
你很勇敢不是吗	你很勇敢不是吗
你的家人在等你	你的家人在等你
你的举止不是很好	你的举止不是很好
你的礼貌不是很好	你的礼貌不是很好
穷鼠囓狸	穷鼠囓狸
我觉得不舒服	我觉得不舒服
台风正接近日本	台风正接近日本
入场费是3美元	入场费是3美元
儿童免费入场	儿童免费入场
他只顾自己的利益	他只顾自己的利益
麻烦再一瓶葡萄酒	麻烦再一瓶葡萄酒
你是执业医师吗	你是执业医师吗
你对政治感兴趣吗	你对政治感兴趣吗
对于我我不反对	对于我我不反对
小心不要感冒老	小心不要感冒了
请把报纸拿来给我	请把报纸拿来给我
你不能打一点折吗	你不能打一点折吗
你不能待久一点吗	你不能待久一点吗
最晚十点前来这里	最晚十点前来这里
你可以载我回家吗	你可以载我回家吗
乌云是下雨的征兆	乌云是下雨的征兆
你昨天切上学老吗	你昨天去上学了吗
你相信神存在吗	你相信神存在吗
你周末切学校吗	你周末去学校吗
你有驾驶执照吗	你有驾驶执照吗
你有止咳药吗	你有止咳药吗
你身上有钱吗	你身上有钱吗
你知道如何开车吗	你知道如何开车吗
你喜欢打排球吗	你喜欢打排球吗
你介意我开门吗	你介意我开门吗
你以为我造钱啊	你以为我造钱啊
你想要啥子喝的吗	你想要什么喝的吗
你今晚想出切吃吗	你今晚想出去吃吗
你想再待下切吗	你想再待下去吗
他知道你爱他吗	他知道你爱他吗
不要再上学迟到老	不要再上学迟到了
不要忘老寄这封信	不要忘了寄这封信
别忘老带个相机	别忘了带个相机
千万别理汤姆	千万别理汤姆
不要踩在碎玻璃上	不要踩在碎玻璃上
阅览室里禁止说话	阅览室里禁止说话
不要对狗丢石头	不要对狗丢石头
不要丢掉这本杂志	不要丢掉这本杂志
别用机翻	别用机翻
司机应该系安全带	司机应该系安全带
英语很难不是吗	英语很难不是吗
在澳洲的人说英语	在澳洲的人说英语
连他的仆人都鄙视他	连他的仆人都鄙视他
大家都说我是错的	大家都说我是错的
经验是最好的老师	经验是最好的老师
父亲正忙着写信	父亲正忙着写信
恐惧很快变成愤怒	恐惧很快变成愤怒
尽管提问	尽管提问
给我一些纸来写字	给我一些纸来写字
给我三片鲑鱼肉	给我三片鲑鱼肉
金子比水重得多	金子比水重得多
你以前切过伦敦吗	你以前去过伦敦吗
你曾爬过枪岳吗	你曾爬过枪岳吗
你找到你的票老吗	你找到你的票了吗
你把电影全看老吗	你把电影全看了吗
你交报告老吗	你交报告了吗
你洗过你的手老吗	你洗过你的手了吗
你解开谜团老吗	你解开谜团了吗
他总是支持她	他总是支持她
他申请老奖学金	他申请了奖学金
铃响后他就到老	铃响后他就到了
他问我为啥子在笑	他问我为什么在笑
他故意打破老窗户	他故意打破了窗户
他两年前来日本	他两年前来日本
他一次搬6个箱子	他一次搬6个箱子
他几乎每天都来	他几乎每天都来
他否认曾写信给我	他否认曾写信给我
他不接受我的道歉	他不接受我的道歉
他不同意我的建议	他不同意我的建议
他并不完全信任我	他并不完全信任我
他不是每天都来这	他不是每天都来这
他一点也不懂英语	他一点也不懂英语
他喝老三瓶啤酒	他喝了三瓶啤酒
他靠写作谋生	他靠写作谋生
他莫得回信	他没有回信
他在下一站下车老	他在下一站下车了
他找工作不走运	他找工作不走运
他不幸找不到工作	他不幸找不到工作
他精通英文	他精通英文
他有很多外国邮票	他有很多外国邮票
他已经死老十年	他已经死了十年
他以前曾在北海道	他以前曾在北海道
他刚成为一名校长	他刚成为一名校长
他莫得成功的机会	他没有成功的机会
他对政治莫得兴趣	他对政治没有兴趣
他是个很体贴的人	他是个很体贴的人
他今天没上学	他今天没上学
他怕自己的影子	他怕自己的影子
他是个胆小鬼	他是个胆小鬼
他总是忘记事情	他总是忘记事情
他明天将飞往巴黎	他明天将飞往巴黎
他经常翘课	他经常翘课
失败的责任在他	失败的责任在他
他比你大两岁	他比你大两岁
他习惯早起	他习惯早起
他知道如何弹钢琴	他知道如何弹钢琴
他不辞而别	他不辞而别
他喜欢音乐和运动	他喜欢音乐和运动
他喜欢地理和历史	他喜欢地理和历史
他居住在国外多年	他居住在国外多年
他在大学主修戏剧	他在大学主修戏剧
他以唱歌为生	他以唱歌为生
他把门漆成老白色	他把门漆成了白色
他每天在家练习	他每天在家练习
他按下老紧急按钮	他按下了紧急按钮
他晚上回来得很晚	他晚上回来得很晚
他说你最好切	他说你最好去
他和他的朋友握手	他和他的朋友握手
他在那里待老三天	他在那里待了三天
他把球扔过老栅栏	他把球扔过了栅栏
他为无尾熊拍照	他为无尾熊拍照
他周游全国各地	他周游全国各地
他每天早晨溜狗	他每天早晨溜狗
他想在医院工作	他想在医院工作
他在澳大利亚长大	他在澳大利亚长大
他被迫加班	他被迫加班
他当时在美国	他当时在美国
他在事故中受伤	他在事故中受伤
他被卷进老是非中	他被卷进了是非中
他在树下睡觉	他在树下睡觉
他等老很长的时间	他等了很长的时间
他伤老肩膀	他伤了肩膀
他穿中式服装	他穿中式服装
他切老某个地方	他去了某个地方
他十分钟后会回来	他十分钟后会回来
他会来参加派对	他会来参加派对
他明天将打棒球	他明天将打棒球
他今晚将抵达函馆	他今晚将抵达函馆
他受到学生的欢迎	他受到学生的欢迎
他坐在一张空桌旁	他坐在一张空桌旁
他开始找工作老	他开始找工作了
他比我大三岁	他比我大三岁
她的头发长而美丽	她的头发长而美丽
她的嗜好是集邮	她的嗜好是集邮
她的母亲正在写信	她的母亲正在写信
她的母亲敲门	她的母亲敲门
他的衣服过时老	他的衣服过时了
他的房子在街对面	他的房子在街对面
他家离这儿不远	他家离这儿不远
他的方法不科学	他的方法不科学
他的母亲来接他老	他的母亲来接他了
出切散步啷个样	出去散步怎么样
出切吃晚餐如何	出去吃晚餐如何
我要啷个解释	我要怎么解释
您要啥子样的蛋	您要什么样的蛋
你的蛋要啷个做	你的蛋要怎么做
你啷个唸你的名字	你怎么唸你的名字
你在神户多久老	你在神户多久了
你来这里多久老	你来这里多久了
彩虹桥有多长	彩虹桥有多长
会议持续多久	会议持续多久
那辆山地车多少钱	那辆山地车多少钱
一个月的租金多少	一个月的租金多少
我为她作钢琴伴奏	我为她作钢琴伴奏
我建议你换衣服	我建议你换衣服
我同意你这一点	我同意你这一点
我总是试着说实话	我总是试着说实话
我星期日总是在家	我星期日总是在家
我明年要切夏威夷	我明年要去夏威夷
我赞成你的建议	我赞成你的建议
我一点也不担心	我一点也不担心
我确定他是错的	我确定他是错的
我对法语很感兴趣	我对法语很感兴趣
我叫汤姆弹吉他	我叫汤姆弹吉他
我请他把窗户打开	我请他把窗户打开
我问老他要切哪里	我问了他要去哪里
我买老一瓶沙拉油	我买了一瓶沙拉油
我买老两条裤子	我买了两条裤子
我已经会写中文老	我已经会写中文了
我十分能理解他	我十分能理解他
我完全不明白	我完全不明白
我一点也不懂这个	我一点也不懂这个
我再同意你不过老	我再同意你不过了
我无法忍受看着她	我无法忍受看着她
我不是想要羞辱你	我不是想要羞辱你
我不想吃寿司	我不想吃寿司
我不太想说话	我不太想说话
我可莫得那閒空	我可没有那閒空
我不喜欢他说的话	我不喜欢他说的话
我不太看报纸	我不太看报纸
我不觉得他诚实	我不觉得他诚实
我啥子都不想喝	我什么都不想喝
我不想再次切那儿	我不想再次去那儿
我不想再失切你	我不想再失去你
我不想等那么久	我不想等那么久
我觉得我快昏倒老	我觉得我快昏倒了
我下错老车站	我下错了车站
我想我现在得走老	我想我现在得走了
我有个盲邻居	我有个盲邻居
我的手指莫得感觉	我的手指没有感觉
我必须把文身切掉	我必须把文身去掉
我有很多作业要做	我有很多作业要做
我身上几乎莫得钱	我身上几乎没有钱
我认识她两年老	我认识她两年了
我和老板莫得问题	我和老板没有问题
我身上带着很多钱	我身上带着很多钱
我不能再拖延老	我不能再拖延了
我听说你弹钢琴	我听说你弹钢琴
我听说你擅长烹饪	我听说你擅长烹饪
我听见老他下楼	我听见了他下楼
我紧紧地抱着他哭	我紧紧地抱着他哭
我就是不想嫁给你	我就是不想嫁给你
我只是没注意	我只是没注意
我喜欢切看棒球	我喜欢去看棒球
我喜欢读美国小说	我喜欢读美国小说
我喜欢看棒球比赛	我喜欢看棒球比赛
爱她爱得要命	爱她爱得要命
我设法及时到那里	我设法及时到那里
我常常和她打网球	我常常和她打网球
我晚饭后弹吉他	我晚饭后弹吉他
我放学后弹吉他	我放学后弹吉他
我真该睡一觉老	我真该睡一觉了
我整天待在图书馆	我整天待在图书馆
我还没收到他的信	我还没收到他的信
我几乎每天洗澡	我几乎每天洗澡
我想他们会迟到	我想他们会迟到
我依稀记得见过他	我依稀记得见过他
我想喝点冷饮	我想喝点冷饮
我想买点东西吃	我想买点东西吃
我想喝冷饮	我想喝冷饮
有一天我要切非洲	有一天我要去非洲
我想跟你叔叔谈谈	我想跟你叔叔谈谈
我刚才正要找你	我刚才正要找你
我约会迟到老	我约会迟到了
他的行为冒犯老我	他的行为冒犯了我
我该切上学	我该去上学
我担心他的健康	我担心他的健康
我明天要切北海道	我明天要去北海道
我会让你提前知道	我会让你提前知道
我会为你弹吉他	我会为你弹吉他
我会教你下棋	我会教你下棋
我想切纽约	我想去纽约
我要预约	我要预约
我想用信用卡支付	我想用信用卡支付
我想待一夜	我想待一夜
我早上会在家	我早上会在家
我为你煮马铃薯	我为你煮马铃薯
我会来尽可能常来	我会来尽可能常来
我会尽力帮你	我会尽力帮你
我赌上我的名声	我赌上我的名声
我明天会来看你	我明天会来看你
我秋天要切巴黎	我秋天要去巴黎
我要切换衣服	我要去换衣服
我明天要跟他见面	我明天要跟他见面
我不会表现出恐惧	我不会表现出恐惧
我在省钱买新车	我在省钱买新车
我开始同意你老	我开始同意你了
我在学几门语言	我在学几门语言
我确定他明天会来	我确定他明天会来
我看完老这本书	我看完了这本书
工作一切顺利吗	工作一切顺利吗
我现在进来方便么	我现在进来方便么
有你不能做的事吗	有你不能做的事吗
看来他搞错老	看来他搞错了
可能只是巧合	可能只是巧合
他说的不重要	他说的不重要
一定是汤姆做的	一定是汤姆做的
今晚会很冷	今晚会很冷
担心它是莫得用的	担心它是没有用的
我仍然记忆犹新	我仍然记忆犹新
一个小时前雪停老	一个小时前雪停了
结果证明我是对的	结果证明我是对的
在公园里玩很有趣	在公园里玩很有趣
昨天不是很冷	昨天不是很冷
今天下午非常炎热	今天下午非常炎热
到车站的路程很远	到车站的路程很远
汤姆快该走老	汤姆快该走了
深呼吸有益健康	深呼吸有益健康
你要想到你必须死	你要想到你必须死
保持在较低的温度	保持在较低的温度
吉隆坡值得一游	吉隆坡值得一游
京都不如大坂大	京都不如大坂大
让我们来拍照吧	让我们来拍照吧
让我们唱英文歌曲	让我们唱英文歌曲
有些人害怕婚姻	有些人害怕婚姻
玛丽昨晚熬夜	玛丽昨晚熬夜
精通英语是困难的	精通英语是困难的
妈妈每天待在家里	妈妈每天待在家里
富士山被雪所覆盖	富士山被雪所覆盖
我哥哥现在在澳洲	我哥哥现在在澳洲
我女儿喜欢跳绳	我女儿喜欢跳绳
我的狗总是跟着我	我的狗总是跟着我
我父亲住在乡下	我父亲住在乡下
我父亲要我洗车	我父亲要我洗车
我的祖父非常健康	我的祖父非常健康
我的祖父是警察	我的祖父是警察
我的腿比你的小	我的腿比你的小
我父母住在乡下	我父母住在乡下
我的鞋比你的大	我的鞋比你的大
我妹妹上大学	我妹妹上大学
我叔叔住在公寓里	我叔叔住在公寓里
这些书都莫得用	这些书都没有用
也许她明天会来	也许她明天会来
请不要开窗	请不要开窗
请给我一张废纸	请给我一张废纸
请给我一杯牛奶	请给我一杯牛奶
请让别人切做	请让别人去做
请帮我打扫房子	请帮我打扫房子
请帮我寄信	请帮我寄信
请帮我做个奶昔	请帮我做个奶昔
请说话大声一点	请说话大声一点
请带我切医院	请带我去医院
请告诉我一切都好	请告诉我一切都好
请想想这个问题	请想想这个问题
请把电视关掉	请把电视关掉
请等到他回来	请等到他回来
再往火里添些木柴	再往火里添些木柴
把书放回书架上	把书放回书架上
把蛋放入沸水中	把蛋放入沸水中
她骂我是个骗子	她骂我是个骗子
她问老啷个烧鱼	她问了怎么烧鱼
她问老我要切哪里	她问了我要去哪里
她从加拿大来看我	她从加拿大来看我
她从屋顶上下来老	她从屋顶上下来了
她用刀子切苹果	她用刀子切苹果
她看见血就晕老	她看见血就晕了
她的英文成绩很好	她的英文成绩很好
她免费得到这张票	她免费得到这张票
她竟敢说出来	她竟敢说出来
她有胆量说出来	她有胆量说出来
她有很多英文书	她有很多英文书
她从未切过北海道	她从未去过北海道
她最近增加老体重	她最近增加了体重
她总是一身黑	她总是一身黑
她缺乏常识	她缺乏常识
她一整晚都在哭	她一整晚都在哭
她守着这个秘密	她守着这个秘密
她喜欢切图书馆	她喜欢去图书馆
她星期日很少出门	她星期日很少出门
她以前定期来看我	她以前定期来看我
她等老好几个小时	她等了好几个小时
她怕独自旅行	她怕独自旅行
她上学几乎迟到	她上学几乎迟到
她被警方逮捕老	她被警方逮捕了
她忙着编织	她忙着编织
她下楼	她下楼
她边哭边回答	她边哭边回答
她要哭出来老	她要哭出来了
切年她离开老日本	去年她离开了日本
她一周之内会回来	她一周之内会回来
她比你大两岁	她比你大两岁
严禁吸烟	严禁吸烟
得有人做点啥子	得有人做点什么
有人在敲门	有人在敲门
对不起让你一直等	对不起让你一直等
别找事汤姆	别找事汤姆
停止愚弄你自己	停止愚弄你自己
现在是草莓的季节	现在是草莓的季节
我在星期日不工作	我在星期日不工作
夜里游泳很危险	夜里游泳很危险
谢谢您的合作	谢谢您的合作
谢谢你的翻译	谢谢你的翻译
谢谢您今晚的光临	谢谢您今晚的光临
这孩子能数到20	这孩子能数到20
那部电影很有意思	那部电影很有意思
那座山很容易爬	那座山很容易爬
这只是偶发事件	这只是偶发事件
那树是汤姆的财产	那树是汤姆的财产
那是个很大的设想	那是个很大的设想
这辆公车客满老	这辆公车客满了
汽车撞上老卡车	汽车撞上了卡车
车在门口等着	车在门口等着
城堡在河的对面	城堡在河的对面
这个小孩身体很烫	这个小孩身体很烫
孩子们怕汤姆	孩子们怕汤姆
孩子们跑下老山丘	孩子们跑下了山丘
孩子们在放风筝	孩子们在放风筝
这个城市毁于火灾	这个城市毁于火灾
生活费提高老	生活费提高了
小屋干净又整洁	小屋干净又整洁
狗坐在碗旁边	狗坐在碗旁边
比赛在九点钟结束	比赛在九点钟结束
法律不应受到侵犯	法律不应受到侵犯
钱还没用完	钱还没用完
派对在十点钟结束	派对在十点钟结束
飞机向西飞老	飞机向西飞了
警方拘留老他	警方拘留了他
这个问题非常困难	这个问题非常困难
路正在建	路正在建
这首歌让我想家老	这首歌让我想家了
太阳在晚上不亮	太阳在晚上不亮
毛巾完全没起作用	毛巾完全没起作用
红绿灯变成绿色老	红绿灯变成绿色了
两队打老场硬仗	两队打了场硬仗
村里没通电	村里没通电
访客坐在我的对面	访客坐在我的对面
天花板上有洞	天花板上有洞
市中心有很多旅馆	市中心有很多旅馆
天上莫得云	天上没有云
盒子里有一些蛋	盒子里有一些蛋
墙上有一幅画	墙上有一幅画
桌上有个苹果	桌上有个苹果
莫得不冒烟的火	没有不冒烟的火
天上莫得一片云	天上没有一片云
房间里莫得任何人	房间里没有任何人
以前这里有一座桥	以前这里有一座桥
这口井里莫得水	这口井里没有水
花园里莫得人	花园里没有人
院子里的是狗屋	院子里的是狗屋
我的房里有部电话	我的房里有部电话
总是会有人谈论	总是会有人谈论
总是会有人说话	总是会有人说话
没必要叫出租车	没必要叫出租车
你的卧室里莫得人	你的卧室里没有人
莫得生气的理由	没有生气的理由
他们正向森林而切	他们正向森林而去
他们决定建一座桥	他们决定建一座桥
他们莫得信守诺言	他们没有信守诺言
他们玩牌来杀时间	他们玩牌来杀时间
他们昨天学习英语	他们昨天学习英语
他们明天才会来	他们明天才会来
事情还没解释清楚	事情还没解释清楚
这辆车不值得修理	这辆车不值得修理
我看这不正常	我看这不正常
这狗屋是汤姆建的	这狗屋是汤姆建的
这是我姊姊的照片	这是我姊姊的照片
这是我住的房子	这是我住的房子
这药对你有好处	这药对你有好处
这张桌子是木的	这张桌子是木的
汤姆让玛丽停住车	汤姆让玛丽停住车
汤姆没做解释	汤姆没做解释
汤姆死于交通事故	汤姆死于交通事故
汤姆骑摩托车上班	汤姆骑摩托车上班
汤姆有一大罐零钱	汤姆有一大罐零钱
汤姆很合作	汤姆很合作
汤姆是法语母语者	汤姆是法语母语者
汤姆日夜兼程	汤姆日夜兼程
汤姆很可能迟到	汤姆很可能迟到
汤姆上夜班	汤姆上夜班
汤姆对此不严格	汤姆对此不严格
汤姆现在就需要钱	汤姆现在就需要钱
汤姆打开老电风扇	汤姆打开了电风扇
汤姆脱光睡觉老	汤姆脱光睡觉了
汤姆不敢求助	汤姆不敢求助
汤姆切那里学法语	汤姆去那里学法语
明天我得购物	明天我得购物
我明天要切上海	我明天要去上海
在十字路口右转	在十字路口右转
下下一站是上野站	下下一站是上野站
我们明天要离开	我们明天要离开
我们别无选择	我们别无选择
我们玩的很开心	我们玩的很开心
昨晚下老一场大雨	昨晚下了一场大雨
昨天下很多雨	昨天下很多雨
切年冬天很暖和	去年冬天很暖和
我们要做些决定	我们要做些决定
我们早餐做老煎饼	我们早餐做了煎饼
我们昨天打篮球	我们昨天打篮球
我们沿着河散步	我们沿着河散步
我们参加老讨论	我们参加了讨论
我们轮流驾驶	我们轮流驾驶
我们几乎被冻死老	我们几乎被冻死了
雨停老我们就会切	雨停了我们就会去
我们要建立避难所	我们要建立避难所
我们快要结束老	我们快要结束了
我们对你很失望	我们对你很失望
穿你想穿的	穿你想穿的
你上个月在美国吗	你上个月在美国吗
你今天要做啥子	你今天要做什么
你用那本书做啥子	你用那本书做什么
你说你叫啥子名字	你说你叫什么名字
你要这钱干嘛	你要这钱干嘛
你实际上想说啥子	你实际上想说什么
你早餐想要吃啥子	你早餐想要吃什么
其他人啷个想	其他人怎么想
他在信上说啥子	他在信上说什么
你还发现啥子老	你还发现什么了
你的电脑啷个老	你的电脑怎么了
你把我的笔啷个老	你把我的笔怎么了
这条河叫啥子名字	这条河叫什么名字
你们想吃啥子	你们想吃什么
你晚餐想吃啥子	你晚餐想吃什么
今天的汇率是多少	今天的汇率是多少
那样做有啥子用	那样做有什么用
干嘛那么麻烦	干嘛那么麻烦
最坏的情境是啥子	最坏的情境是什么
你们要带我切哪	你们要带我去哪
你打算在哪里留宿	你打算在哪里留宿
这条街通到哪里	这条街通到哪里
你指的是哪个	你指的是哪个
你在车站看见老哪个	你在车站看见了谁
这本书的作者是哪个	这本书的作者是谁
哪个将照顾这个婴儿	谁将照顾这个婴儿
你为啥子这么神秘	你为什么这么神秘
你为甚么买日本车	你为甚么买日本车
您允许我切吗	您允许我去吗
你收私人支票吗	你收私人支票吗
你想再喝点咖啡吗	你想再喝点咖啡吗
你要来杯咖啡吗	你要来杯咖啡吗
你想再来些酱汁吗	你想再来些酱汁吗
你想做我的朋友吗	你想做我的朋友吗
你愿意解释吗	你愿意解释吗
请你锁门好吗	请你锁门好吗
请你开门好吗	请你开门好吗
你会开车不是吗	你会开车不是吗
你可以从银行贷款	你可以从银行贷款
你不必搭计程车	你不必搭计程车
你不必早起	你不必早起
你不想做编辑	你不想做编辑
你很有幽默感	你很有幽默感
你不需要害羞	你不需要害羞
你必须切医院	你必须去医院
你必须事先预约	你必须事先预约
你必须永远说实话	你必须永远说实话
你一定要鼓起勇气	你一定要鼓起勇气
你要让我来解决	你要让我来解决
你应该多吃蔬菜	你应该多吃蔬菜
你早就该开始老	你早就该开始了
你从来不该干涉	你从来不该干涉
你昨晚确实很吵	你昨晚确实很吵
你最好马上切睡觉	你最好马上去睡觉
你最好立马切睡觉	你最好立马去睡觉
您最好穿一件雨衣	您最好穿一件雨衣
你要接电话	你要接电话
有一天你会忘老我	有一天你会忘了我
你是要做决定的人	你是要做决定的人
你的建议有点极端	你的建议有点极端
滚石不生苔	滚石不生苔
行动胜于雄辩	行动胜于雄辩
坐而言不如起而行	坐而言不如起而行
行动比语言更响亮	行动比语言更响亮
法律之前人人平等	法律之前人人平等
你们三个很走运	你们三个很走运
四月春雨五月花	四月春雨五月花
箱子里有苹果吗	箱子里有苹果吗
还有其他建议吗	还有其他建议吗
明天下午你忙吗	明天下午你忙吗
你明天下午有空吗	你明天下午有空吗
你是说你放弃老吗	你是说你放弃了吗
你还在收集邮票吗	你还在收集邮票吗
问她要多少汤	问她要多少汤
她在夜晚望着月亮	她在夜晚望着月亮
我父母现在都在家	我父母现在都在家
接受现金捐赠	接受现金捐赠
你能请个医生来吗	你能请个医生来吗
请你写下来好吗	请你写下来好吗
你给你父母看老吗	你给你父母看了吗
我必须吃这个药吗	我必须吃这个药吗
你搭公车上下学吗	你搭公车上下学吗
你想切游泳吗	你想去游泳吗
你跟老板合得来吗	你跟老板合得来吗
你星期六切上学吗	你星期六去上学吗
你星期六要上学吗	你星期六要上学吗
你真的相信鬼吗	你真的相信鬼吗
你还想跟我谈吗	你还想跟我谈吗
你要喝水吗	你要喝水吗
这儿有人说日语吗	这儿有人说日语吗
他每天研读英语吗	他每天研读英语吗
你爸爸很早回家吗	你爸爸很早回家吗
狗的嗅觉灵敏	狗的嗅觉灵敏
别怕吠犬	别怕吠犬
不要犹豫切问问题	不要犹豫去问问题
每朵云都披着银衣	每朵云都披着银衣
自由非常非常重要	自由非常非常重要
尽快把它完成	尽快把它完成
沿着这条街直走	沿着这条街直走
语法是很复杂的	语法是很复杂的
到的有我的信吗	到的有我的信吗
你曾看过他游泳吗	你曾看过他游泳吗
你吃完早饭老吗	你吃完早饭了吗
你做完作业老吗	你做完作业了吗
你读过这本书老吗	你读过这本书了吗
我们好像在哪见过	我们好像在哪见过
他建议她戒酒	他建议她戒酒
他今天从雪梨回来	他今天从雪梨回来
他承认有罪	他承认有罪
他周日晚上不工作	他周日晚上不工作
他不喜欢被惩罚	他不喜欢被惩罚
他不必上学	他不必上学
他用水装满老瓶子	他用水装满了瓶子
他忘老关灯	他忘了关灯
他每年都切轻井泽	他每年都去轻井泽
他八点上床睡觉	他八点上床睡觉
他又喝老一碗汤	他又喝了一碗汤
他挟着一个包裹	他挟着一个包裹
他用他的球拍击球	他用他的球拍击球
他把钱投资于股票	他把钱投资于股票
他认识市长	他认识市长
他在日本也很有名	他在日本也很有名
他一点一点地变好	他一点一点地变好
他一天一天地好转	他一天一天地好转
他现在在伦敦洽公	他现在在伦敦洽公
他不是个高中生	他不是个高中生
他不胜任这份工作	他不胜任这份工作
他非常怕他的母亲	他非常怕他的母亲
他忙于写故事	他忙于写故事
他知道啷个刷牙	他知道怎么刷牙
他喜欢听收音机	他喜欢听收音机
他喜欢听广播	他喜欢听广播
他喜欢为家人做饭	他喜欢为家人做饭
他活到老八十岁	他活到了八十岁
他就住在附近	他就住在附近
他设法当上老部长	他设法当上了部长
他主修英国文学	他主修英国文学
他当推销员为生	他当推销员为生
他也许明天能来	他也许明天能来
他从不在深夜出门	他从不在深夜出门
他经常在晚上熬夜	他经常在晚上熬夜
他放学后打棒球	他放学后打棒球
他把手插进口袋里	他把手插进口袋里
他一生独身	他一生独身
他回答说他不知道	他回答说他不知道
他该那样做完老	他该那样做完了
他解决老难题	他解决了难题
他怀疑我说谎	他怀疑我说谎
他认为他是个天才	他认为他是个天才
他威胁要公开	他威胁要公开
他在早餐之前散步	他在早餐之前散步
他生于19世纪	他生于19世纪
他死于一场车祸	他死于一场车祸
他靠着墙	他靠着墙
他站在门后	他站在门后
他搭飞机到纽约老	他搭飞机到纽约了
他切纽约出差老	他去纽约出差了
下个月他会很忙	下个月他会很忙
他不听我的劝告	他不听我的劝告
他切名古屋出差	他去名古屋出差
他比她大三岁	他比她大三岁
他的马跳过老栅栏	他的马跳过了栅栏
他的谦逊值得尊敬	他的谦逊值得尊敬
他的母亲不想做	他的母亲不想做
今晚下棋啷个样	今晚下棋怎么样
汤姆啷个能不懂	汤姆怎么能不懂
你的姓氏啷个写	你的姓氏怎么写
你做那事用老多久	你做那事用了多久
你切老日本多久	你去了日本多久
你会待在日本多久	你会待在日本多久
柜子上有几本书	柜子上有几本书
他一个月赚多少	他一个月赚多少
会议啥子时候开始	会议什么时候开始
我此刻正忙着做饭	我此刻正忙着做饭
我熟悉这个主题	我熟悉这个主题
我不害怕任何东西	我不害怕任何东西
我在想那个问题	我在想那个问题
我相信他明天会来	我相信他明天会来
我向我父亲借钱	我向我父亲借钱
我只能给你十分钟	我只能给你十分钟
我不明白他的感受	我不明白他的感受
我抓到他偷钱	我抓到他偷钱
我昨天莫得打网球	我昨天没有打网球
我不想买车	我不想买车
昨天你莫得切学校	昨天你没有去学校
我不知道他在那里	我不知道他在那里
起初我没认出他来	起初我没认出他来
我昨天都没读书	我昨天都没读书
我不想误导任何人	我不想误导任何人
稍微冷点儿不要紧	稍微冷点儿不要紧
我今天不想上班	我今天不想上班
我周日不切学校	我周日不去学校
我家莫得电脑	我家没有电脑
我莫得丝毫的想法	我没有丝毫的想法
我不喜欢假花	我不喜欢假花
我不经常自己切做	我不经常自己去做
我不认为他会来	我不认为他会来
我不明白他说的话	我不明白他说的话
我不想打这架	我不想打这架
我不想冒这个险	我不想冒这个险
我想切看电影	我想去看电影
我倒水进切花瓶里	我倒水进去花瓶里
我猜那应该可以的	我猜那应该可以的
我一周前已经买老	我一周前已经买了
我比汤姆更有经验	我比汤姆更有经验
我还莫得完全吃完	我还没有完全吃完
我只要你跟我来	我只要你跟我来
我知道有些事不对	我知道有些事不对
我非常爱我的祖母	我非常爱我的祖母
我今天必须交报告	我今天必须交报告
我昨天经过她家	我昨天经过她家
我喜欢柚子和橘子	我喜欢柚子和橘子
我保证明天就做	我保证明天就做
今晚我玩得很开心	今晚我玩得很开心
我记得切年看过你	我记得去年看过你
我看见他游过老河	我看见他游过了河
我昨天住在他家	我昨天住在他家
有一天我要切美国	有一天我要去美国
我想见你姐姐	我想见你姐姐
我被高中退学老	我被高中退学了
我下个月买辆新车	我下个月买辆新车
我不会再犯那错老	我不会再犯那错了
我想现在结帐离开	我想现在结帐离开
我会很快跟你联络	我会很快跟你联络
我绝不会让你切做	我绝不会让你去做
我是专业摄影师	我是专业摄影师
我现在在成田机场	我现在在成田机场
我下周日要结婚老	我下周日要结婚了
我下周要切度假	我下周要去度假
我将出席这个会议	我将出席这个会议
我要切爬北岳	我要去爬北岳
我要告诉你真相	我要告诉你真相
此刻我缺少现金	此刻我缺少现金
我很抱歉回复晚老	我很抱歉回复晚了
我留在希尔顿宾馆	我留在希尔顿宾馆
我确定你永不后悔	我确定你永不后悔
我正在考虑切欧洲	我正在考虑去欧洲
我一生都谨慎行事	我一生都谨慎行事
有人请我帮你	有人请我帮你
我喜欢读这本小说	我喜欢读这本小说
我读完老那本书	我读完了那本书
我从没看过那个人	我从没看过那个人
我最近常看到他	我最近常看到他
生活中有高低起伏	生活中有高低起伏
有人敲门吗	有人敲门吗
邮局还关着门吗	邮局还关着门吗
天日渐回暖	天日渐回暖
已经过老五点钟	已经过了五点钟
你早该睡老	你早该睡了
雪从周一哈到周五	雪从周一下到周五
这是奇妙的体验	这是奇妙的体验
等火车很无聊	等火车很无聊
今天晚上会下雨	今天晚上会下雨
这么生气不像他	这么生气不像他
正义终将胜利	正义终将胜利
他后来写信给总统	他后来写信给总统
让我量量你的血压	让我量量你的血压
让我们今晚喝几杯	让我们今晚喝几杯
水是生命的源泉	水是生命的源泉
长发现在过时老	长发现在过时了
许多名人来这里	许多名人来这里
数学对我来说很难	数学对我来说很难
妈妈周日烤曲奇	妈妈周日烤曲奇
我对他的态度变老	我对他的态度变了
我哥哥是个大学生	我哥哥是个大学生
我父亲偶尔出国	我父亲偶尔出国
我的祖父来自大坂	我的祖父来自大坂
我祖母独自生活	我祖母独自生活
我妈妈讨厌写信	我妈妈讨厌写信
我的办公室在五楼	我的办公室在五楼
我的室友在学中文	我的室友在学中文
我妹妹唱歌很好听	我妹妹唱歌很好听
元旦就在眼前	元旦就在眼前
纽约位在哈得逊河	纽约位在哈得逊河
莫得人有话可说	没有人有话可说
她当然会讲英语	她当然会讲英语
只有一些人老解我	只有一些人了解我
我们的母语是日语	我们的母语是日语
请叫消防员	请叫消防员
请尽快过来	请尽快过来
请继续讲你的故事	请继续讲你的故事
请原谅我的鲁莽	请原谅我的鲁莽
请先填写这张表格	请先填写这张表格
请给我点东西吃	请给我点东西吃
请看这本书	请看这本书
请让我为你拍照	请让我为你拍照
带我向你家人问好	带我向你家人问好
请给我们更多讯息	请给我们更多讯息
请先为他上菜	请先为他上菜
请随手关门	请随手关门
油墨快没老	油墨快没了
电视代替老收音机	电视代替了收音机
明天图书馆见	明天图书馆见
废水经常污染海洋	废水经常污染海洋
我弹钢琴为她伴奏	我弹钢琴为她伴奏
她指责我说谎	她指责我说谎
她和我同班	她和我同班
她要求我们别吵她	她要求我们别吵她
她买老两磅的奶油	她买了两磅的奶油
她能游得比我远	她能游得比我远
她不想涉入其中	她不想涉入其中
她不再住在那里老	她不再住在那里了
她只吃蔬菜	她只吃蔬菜
她看完信老	她看完信了
她轻轻地推老门	她轻轻地推了门
她每天早上早起	她每天早上早起
她七点钟到车站	她七点钟到车站
她有一整篮的苹果	她有一整篮的苹果
她是个很坦率的人	她是个很坦率的人
她已经死老十年老	她已经死了十年了
她总是尝试新事物	她总是尝试新事物
她擅长说英语	她擅长说英语
她擅长说英文	她擅长说英文
她在找她的车钥匙	她在找她的车钥匙
她现在八十一岁老	她现在八十一岁了
她非常像她的母亲	她非常像她的母亲
她特地来拜访我	她特地来拜访我
她一定很用功读书	她一定很用功读书
她早上打网球	她早上打网球
她假装生病老	她假装生病了
她真的想减肥	她真的想减肥
她拒绝接受这笔钱	她拒绝接受这笔钱
她上周切旅行老	她上周去旅行了
她把自己关在房里	她把自己关在房里
她整天待在房子里	她整天待在房子里
她上私人钢琴课	她上私人钢琴课
她教阅读和写作	她教阅读和写作
她往往会上学迟到	她往往会上学迟到
她以为我是大夫	她以为我是大夫
她把信成碎片	她把信成碎片
她逐字地翻译它	她逐字地翻译它
她周游世界各地	她周游世界各地
她经常九点睡觉	她经常九点睡觉
她是个数学天才	她是个数学天才
她忙着做她的功课	她忙着做她的功课
她明年将满十七岁	她明年将满十七岁
她不在是因为病老	她不在是因为病了
她在无理取闹	她在无理取闹
她对孩子很有一套	她对孩子很有一套
她善于处理儿童	她善于处理儿童
有人偷老我的行李	有人偷了我的行李
不知是哪个在敲门	不知是谁在敲门
运动有益健康	运动有益健康
慢慢来不急	慢慢来不急
十名囚犯逃狱老	十名囚犯逃狱了
谢谢你来接我	谢谢你来接我
谢谢你来跟我见面	谢谢你来跟我见面
感谢告诉我真相	感谢告诉我真相
那有点难以置信	那有点难以置信
那是值得自豪的事	那是值得自豪的事
这个瓶子装满老水	这个瓶子装满了水
波兰的首都是华沙	波兰的首都是华沙
猫正在沙发上睡觉	猫正在沙发上睡觉
孩子们滑下岸边	孩子们滑下岸边
这个城市人口众多	这个城市人口众多
狗在地毯上睡觉	狗在地毯上睡觉
早起的鸟儿有虫吃	早起的鸟儿有虫吃
这夥人计划抢劫	这夥人计划抢劫
女孩凝视着洋娃娃	女孩凝视着洋娃娃
最大的卧室朝南	最大的卧室朝南
图书馆在四楼	图书馆在四楼
警察起诉他盗窃	警察起诉他盗窃
警方逮捕老嫌疑人	警方逮捕了嫌疑人
现在正是好时候	现在正是好时候
米价下跌老	米价下跌了
问题是他没钱	问题是他没钱
预订好老	预订好了
绳子被拉断老	绳子被拉断了
太阳比月亮大	太阳比月亮大
雷声吓到孩子老	雷声吓到孩子了
火车十分钟后离开	火车十分钟后离开
海啸的警报解除老	海啸的警报解除了
我们俩不属于这儿	我们俩不属于这儿
三年后战争开始老	三年后战争开始了
我房间里有很多书	我房间里有很多书
京都有许多神社	京都有许多神社
那里太多人老	那里太多人了
要做的事太多老	要做的事太多了
附近有一间邮局	附近有一间邮局
莫得理由抱怨	没有理由抱怨
昨晚有一场大火	昨晚有一场大火
河里莫得水老	河里没有水了
这条河的水干老	这条河的水干了
今天不可能下雨	今天不可能下雨
莫得必要这么生气	没有必要这么生气
没啥子好怕的	没什么好怕的
有些事我必须说	有些事我必须说
这些天下老好多雪	这些天下了好多雪
这些焰火真壮观	这些焰火真壮观
他们正在拆这面墙	他们正在拆这面墙
他们用枪武装自己	他们用枪武装自己
他们在花园里种花	他们在花园里种花
他们在一起很愉快	他们在一起很愉快
他们让他签约老	他们让他签约了
他们排队等公车	他们排队等公车
他们用肥皂洗手	他们用肥皂洗手
他们上个月切美国	他们上个月去美国
他们开车切车站	他们开车去车站
他们坐车切车站	他们坐车去车站
他们怕这只大狗	他们怕这只大狗
他们被直升机解救	他们被直升机解救
这本书有很多图片	这本书有很多图片
这本书真的很有趣	这本书真的很有趣
这与你无关	这与你无关
这封信是寄给你	这封信是寄给你
这饭足够三个人吃	这饭足够三个人吃
这个消息莫得道理	这个消息没有道理
汤姆继续他的调查	汤姆继续他的调查
汤姆莫得很多钱	汤姆没有很多钱
汤姆不喜欢做作业	汤姆不喜欢做作业
Tom有兽医背景	Tom有兽医背景
汤姆要以你为傲老	汤姆要以你为傲了
汤姆是班上最高的	汤姆是班上最高的
汤姆习惯早起	汤姆习惯早起
汤姆玛丽不会哭	汤姆玛丽不会哭
汤姆看来完全输老	汤姆看来完全输了
汤姆电视看太多老	汤姆电视看太多了
汤姆的评论不合适	汤姆的评论不合适
汤姆好但不够好	汤姆好但不够好
战争随时可能爆发	战争随时可能爆发
我们无法接近敌人	我们无法接近敌人
我们平分这笔钱	我们平分这笔钱
我们没理由害臊	我们没理由害臊
我们经常讨论天气	我们经常讨论天气
我们在花园里摘花	我们在花园里摘花
我们爬到老半山腰	我们爬到了半山腰
我们切山上滑雪	我们去山上滑雪
我们明天要切野餐	我们明天要去野餐
我们将参加马拉松	我们将参加马拉松
我们要下决心老	我们要下决心了
那时你在学校吗	那时你在学校吗
您为啥子惩罚他们	您为什么惩罚他们
你为啥子惩罚他们	你为什么惩罚他们
你今晚有啥子打算	你今晚有什么打算
你把你的鞋啷个老	你把你的鞋怎么了
早餐前你做啥子	早餐前你做什么
你想让我再说啥子	你想让我再说什么
你最喜欢啥子水果	你最喜欢什么水果
您最喜欢啥子水果	您最喜欢什么水果
印度的人口有多少	印度的人口有多少
我们早饭吃啥子	我们早饭吃什么
你几点值班	你几点值班
你要啥子甜点	你要什么甜点
这个字是啥子意思	这个字是什么意思
你要切哪里度假	你要去哪里度假
你在哪里剪头发	你在哪里剪头发
你在哪里唸高中	你在哪里唸高中
你下一步想切哪里	你下一步想去哪里
你想加入哪一组	你想加入哪一组
哪个在乎她何时结婚	谁在乎她何时结婚
哪个负责这个部门	谁负责这个部门
你啷个还关心这个	你怎么还关心这个
你不会来我家吗	你不会来我家吗
你要我解释一哈吗	你要我解释一下吗
你愿意和我跳舞吗	你愿意和我跳舞吗
你想吃点东西吗	你想吃点东西吗
你介意关上门吗	你介意关上门吗
你今天早上非常早	你今天早上非常早
你不能一心两用	你不能一心两用
你不要自甘堕落	你不要自甘堕落
你最好不要熬夜	你最好不要熬夜
你省老我好多时间	你省了我好多时间
你上学不可以迟到	你上学不可以迟到
这本书你该还给他	这本书你该还给他
你说你有重要新闻	你说你有重要新闻
你应该能解决	你应该能解决
你应该六点前回家	你应该六点前回家
你应该现在做功课	你应该现在做功课
你应该闭上你的嘴	你应该闭上你的嘴
你减肥老不是么	你减肥了不是么
我现在只想睡点觉	我现在只想睡点觉
所有学生都出席老	所有学生都出席了
诚实的人从不偷钱	诚实的人从不偷钱
公园里有很多树吗	公园里有很多树吗
你周日下午忙吗	你周日下午忙吗
你明天要切上学吗	你明天要去上学吗
问那边的警察岗哨	问那边的警察岗哨
有人可以接电话吗	有人可以接电话吗
孩子通常莫得耐心	孩子通常没有耐心
你能再说一次吗	你能再说一次吗
爸爸今天很不耐烦	爸爸今天很不耐烦
有人叫你来这吗	有人叫你来这吗
警察盘问你老吗	警察盘问你了吗
你昨天玩得开心吗	你昨天玩得开心吗
你没写信给他吗	你没写信给他吗
你有更好的理由吗	你有更好的理由吗
你院子里有桌子吗	你院子里有桌子吗
你介意我开窗吗	你介意我开窗吗
你演奏乐器吗	你演奏乐器吗
你还买彩票吗	你还买彩票吗
他用英文写信吗	他用英文写信吗
不要忘老熄火	不要忘了熄火
别和这个人打交道	别和这个人打交道
不要往河里扔石头	不要往河里扔石头
每个人都请教汤姆	每个人都请教汤姆
礼貌过度是烦人的	礼貌过度是烦人的
做运动有利于健康	做运动有利于健康
体育有益健康	体育有益健康
切买三瓶可乐	去买三瓶可乐
你吃过香蕉派吗	你吃过香蕉派吗
你交功课老吗	你交功课了吗
您已经吃过药老吗	您已经吃过药了吗
他要求我讲慢一点	他要求我讲慢一点
他相信他能证明它	他相信他能证明它
他晚上很晚回家	他晚上很晚回家
他七年前来日本	他七年前来日本
他收集老一些讯息	他收集了一些讯息
他无法通过考试	他无法通过考试
他不是很老解日本	他不是很了解日本
他给老我正式批准	他给了我正式批准
昨晚他的车被偷老	昨晚他的车被偷了
他要抚养一大家人	他要抚养一大家人
他有一大家子要养	他有一大家子要养
他有很多历史书籍	他有很多历史书籍
他切世三年老	他去世三年了
他还没回我的信	他还没回我的信
他还没写信	他还没写信
他开始掉头发老	他开始掉头发了
他独立于他的父母	他独立于他的父母
他还坐在长椅上	他还坐在长椅上
他是我部门的主管	他是我部门的主管
他非常吝啬	他非常吝啬
他把球踢进老球门	他把球踢进了球门
他住在伦敦市中心	他住在伦敦市中心
他活到老70岁	他活到了70岁
他独自住在森林里	他独自住在森林里
他住在东京郊区	他住在东京郊区
他很容易发脾气	他很容易发脾气
他爱她她也爱他	他爱她她也爱他
他险些被杀害	他险些被杀害
他经常出国洽商	他经常出国洽商
他弹钢琴她唱歌	他弹钢琴她唱歌
他装作没在听	他装作没在听
他假装听不见	他假装听不见
他说九点老	他说九点了
他本应该更小心的	他本应该更小心的
他有时开车切上班	他有时开车去上班
他在那里待老几天	他在那里待了几天
他故意踩我的脚	他故意踩我的脚
他停止老读报	他停止了读报
他开会往往会迟到	他开会往往会迟到
昨天他带我切公园	昨天他带我去公园
他搭错老车	他搭错了车
他经常搭公车上学	他经常搭公车上学
他等我直到我来	他等我直到我来
他想喝些冷饮	他想喝些冷饮
他能解决这个问题	他能解决这个问题
他被指控偷钱	他被指控偷钱
他昨天上学迟到老	他昨天上学迟到了
他比以前重得多	他比以前重得多
他到巴黎学习法语	他到巴黎学习法语
他明天将抵达巴黎	他明天将抵达巴黎
他不肯听我的劝告	他不肯听我的劝告
他一直住在东京	他一直住在东京
他有资格当选总统	他有资格当选总统
他负责这个部门	他负责这个部门
他一点也不怕蛇	他一点也不怕蛇
他很擅长弹吉他	他很擅长弹吉他
她母亲将继续工作	她母亲将继续工作
一起吃晚餐啷个样	一起吃晚餐怎么样
我们啷个付钱	我们怎么付钱
你为啥子都不说话	你为什么都不说话
你春假放多久	你春假放多久
你将在箱根待多久	你将在箱根待多久
你会说多少种语言	你会说多少种语言
他一个月花费多少	他一个月花费多少
明天天气啷个样	明天天气怎么样
我劝你戒酒	我劝你戒酒
我期待她的来信	我期待她的来信
我准时到达老车站	我准时到达了车站
我问老她一个难题	我问了她一个难题
昨天我出席老会议	昨天我出席了会议
我给你带老点东西	我给你带了点东西
我在车站碰到他	我在车站碰到他
我不能相信你爱我	我不能相信你爱我
我不懂他的意思	我不懂他的意思
我等不及要切度假	我等不及要去度假
我把盒子扛在肩上	我把盒子扛在肩上
我抓到他偷相机	我抓到他偷相机
我在上野站换火车	我在上野站换火车
我上个月没上学	我上个月没上学
我昨天不必读书	我昨天不必读书
我不需要粉刷围墙	我不需要粉刷围墙
我昨晚一夜没阖眼	我昨晚一夜没阖眼
我昨晚没睡	我昨晚没睡
我一点也不要香蕉	我一点也不要香蕉
我不怪你那样做	我不怪你那样做
我莫得别的问题老	我没有别的问题了
我不介意等一会儿	我不介意等一会儿
我认为没人能做到	我认为没人能做到
我不认为她会来	我不认为她会来
我不认为你该改变	我不认为你该改变
我一点也不懂德语	我一点也不懂德语
我完全不懂德语	我完全不懂德语
我不明白这句话	我不明白这句话
我对政治很感兴趣	我对政治很感兴趣
我忘老会议的日期	我忘了会议的日期
我昨天必须加班	我昨天必须加班
我有今晚的预订	我有今晚的预订
我无意辞职	我无意辞职
我不反对你的计划	我不反对你的计划
我今晚没地方睡觉	我今晚没地方睡觉
我最近戒烟老	我最近戒烟了
我还没吃完早饭	我还没吃完早饭
我还没吃完晚饭	我还没吃完晚饭
我打算切理发店	我打算去理发店
我住在东京郊区	我住在东京郊区
我三年前住在日本	我三年前住在日本
我爱你多于你爱我	我爱你多于你爱我
我重视准时	我重视准时
我昨天非常想念你	我昨天非常想念你
我常常在河里游泳	我常常在河里游泳
我在海边度假	我在海边度假
我想我今晚会洗澡	我想我今晚会洗澡
我认为它真是好事	我认为它真是好事
我觉得她知道真相	我觉得她知道真相
我看你该做这交易	我看你该做这交易
我想成为决策的人	我想成为决策的人
我今天想切看电影	我今天想去看电影
我想认识你姐姐	我想认识你姐姐
我明年想出国留学	我明年想出国留学
我想成为哲学家	我想成为哲学家
我昨天没切上班	我昨天没去上班
我只是试着保护你	我只是试着保护你
我接种老流感疫苗	我接种了流感疫苗
我昨天切老医院	我昨天去了医院
我明天会问他	我明天会问他
我明天不会切学校	我明天不会去学校
我现在想点饮料	我现在想点饮料
我给你写下老地址	我给你写下了地址
我要三磅的鸡肉	我要三磅的鸡肉
我问他忙不忙	我问他忙不忙
我明天会回日本	我明天会回日本
我载你到车站	我载你到车站
我是个国中生	我是个国中生
我总是忙于功课	我总是忙于功课
我将在下一站下车	我将在下一站下车
我要帮你营救汤姆	我要帮你营救汤姆
我不会再回来老	我不会再回来了
我吃腻老汉堡	我吃腻了汉堡
我确定他会准时来	我确定他会准时来
我比你小三岁	我比你小三岁
我厌倦老看电视	我厌倦了看电视
我很担心我的体重	我很担心我的体重
我已经写完信老	我已经写完信了
我刚刚抵达老机场	我刚刚抵达了机场
我刚开始打网球	我刚开始打网球
我从没在晚上钓鱼	我从没在晚上钓鱼
我好久不见他老	我好久不见他了
说谎总是一种罪吗	说谎总是一种罪吗
这附近有邮局吗	这附近有邮局吗
这附近有超市吗	这附近有超市吗
你啷个想无关紧要	你怎么想无关紧要
已经下老两天的雨	已经下了两天的雨
一天天热起来老	一天天热起来了
那里连夏天也冷	那里连夏天也冷
生活在日本很昂贵	生活在日本很昂贵
明天天气可能很好	明天天气可能很好
要精通英语不容易	要精通英语不容易
现在是零下十度	现在是零下十度
看起来快下雪老	看起来快下雪了
我想应该在这附近	我想应该在这附近
昨天上午下大雨	昨天上午下大雨
似乎很明显他病老	似乎很明显他病了
开个聚会很好	开个聚会很好
它至少要花五美元	它至少要花五美元
实际上莫得那么难	实际上没有那么难
明天是她五岁生日	明天是她五岁生日
你帮我真好	你帮我真好
让孩子远离池塘	让孩子远离池塘
昨晚是满月	昨晚是满月
笑一笑十年少	笑一笑十年少
让他们照顾自己	让他们照顾自己
让我们趁热吃吧	让我们趁热吃吧
让我们轮流划船	让我们轮流划船
伦敦是英国的首都	伦敦是英国的首都
许多人在排队等候	许多人在排队等候
我哥哥要出国唸书	我哥哥要出国唸书
我爸爸有点守旧	我爸爸有点守旧
我父亲每天散步	我父亲每天散步
我的祖父很长寿	我的祖父很长寿
我家离这儿很远	我家离这儿很远
我妈妈比我早起	我妈妈比我早起
我妈妈现在在医院	我妈妈现在在医院
永远不要忘记关火	永远不要忘记关火
莫得一个人迟到	没有一个人迟到
我们的棒球队很强	我们的棒球队很强
我可能能帮你	我可能能帮你
请开车开慢一点	请开车开慢一点
请原谅我迟到	请原谅我迟到
你自己拿蛋糕吃吧	你自己拿蛋糕吃吧
请把桌子向左移	请把桌子向左移
抱歉那么晚来	抱歉那么晚来
请把书放在架子上	请把书放在架子上
不少人有两辆汽车	不少人有两辆汽车
她总是低声地说话	她总是低声地说话
我和她是兄妹	我和她是兄妹
她和我是姐弟	她和我是姐弟
她要求他打开窗户	她要求他打开窗户
她请他打开窗口	她请他打开窗口
她相信他是无辜的	她相信他是无辜的
她会讲英语当然	她会讲英语当然
她跳入老游泳池	她跳入了游泳池
她不在乎她的穿着	她不在乎她的穿着
她上女子高中	她上女子高中
她25岁就结婚老	她25岁就结婚了
她大方地道歉	她大方地道歉
她帮我清除积雪	她帮我清除积雪
她把画挂反老	她把画挂反了
她喜欢唱老歌	她喜欢唱老歌
她一天一天地好转	她一天一天地好转
她今年秋天要结婚	她今年秋天要结婚
她下周要切法国	她下周要去法国
她擅长弹钢琴	她擅长弹钢琴
她知道如何弹吉他	她知道如何弹吉他
她在花园里摘花	她在花园里摘花
她答应不单独外出	她答应不单独外出
她拒绝让我帮助她	她拒绝让我帮助她
她终生未婚	她终生未婚
她独自度过老周末	她独自度过了周末
她透过传译员发言	她透过传译员发言
她站在镜子前	她站在镜子前
她停下来抽老根烟	她停下来抽了根烟
她等老你两个小时	她等了你两个小时
她被指责说老谎	她被指责说了谎
她怕过马路	她怕过马路
她下五楼切老	她下五楼去了
她上楼到她的卧室	她上楼到她的卧室
她和男人一起工作	她和男人一起工作
她是按摩师	她是按摩师
她问这啷个可能	她问这怎么可能
烟从烟囱上升	烟从烟囱上升
有些人只追求快乐	有些人只追求快乐
我的车出老点事	我的车出了点事
聊胜于无	聊胜于无
我的手表坏老	我的手表坏了
我的表出老毛病	我的表出了毛病
我的相机坏老	我的相机坏了
我的相机有毛病	我的相机有毛病
春天快来老	春天快来了
慢慢来没那么急	慢慢来没那么急
十支队伍竞逐奖项	十支队伍竞逐奖项
病人随时会死	病人随时会死
美国与加拿大相邻	美国与加拿大相邻
空调故障老	空调故障了
观众深受感动	观众深受感动
鸟儿成群飞着	鸟儿成群飞着
船从桥下通过	船从桥下通过
时钟在壁炉的上方	时钟在壁炉的上方
医生检查老病人	医生检查了病人
这只狗穿过街道	这只狗穿过街道
汽车油箱是满的	汽车油箱是满的
历史课九点开始	历史课九点开始
痛开始减轻老	痛开始减轻了
公园里都是孩子	公园里都是孩子
派对延期老一周	派对延期了一周
警方指控他谋杀	警方指控他谋杀
雨大得让我不能走	雨大得让我不能走
河从桥下流过	河从桥下流过
谣言是毫无根据的	谣言是毫无根据的
学校在山丘顶上	学校在山丘顶上
这条街铺上老柏油	这条街铺上了柏油
游泳选手们冻僵老	游泳选手们冻僵了
桌上布满老粉末	桌上布满了粉末
桌布在橱柜里	桌布在橱柜里
电话响老好几次	电话响了好几次
全家都病倒老	全家都病倒了
这个湖里有很多鱼	这个湖里有很多鱼
书桌上有几本书	书桌上有几本书
桌子上有一台电脑	桌子上有一台电脑
有足够的光线读书	有足够的光线读书
他莫得希望痊癒老	他没有希望痊癒了
8月份没课	8月份没课
没时间解释	没时间解释
十点钟有一班火车	十点钟有一班火车
昨天下小雨	昨天下小雨
你莫得读书的必要	你没有读书的必要
他们任命他为经理	他们任命他为经理
他们在互相交谈	他们在互相交谈
他们闯进老珠宝店	他们闯进了珠宝店
他们解除老婚约	他们解除了婚约
他们前进老几步	他们前进了几步
他们在听收音机	他们在听收音机
他们没在听音乐	他们没在听音乐
他们被老师训斥老	他们被老师训斥了
现在全都不一样老	现在全都不一样了
这件T卹太小老	这件T卹太小了
这本书是图书馆的	这本书是图书馆的
这本书值得读两遍	这本书值得读两遍
这本书在英国印刷	这本书在英国印刷
这条延长线太短老	这条延长线太短了
这食物不适合我	这食物不适合我
这是一个例外	这是一个例外
这是他住的房子	这是他住的房子
这是我唯一的相机	这是我唯一的相机
这封信寄错地方老	这封信寄错地方了
这句话没意思	这句话没意思
这拉鍊卡卡的	这拉鍊卡卡的
汤姆莫得还我钱	汤姆没有还我钱
汤姆不喜欢戴手表	汤姆不喜欢戴手表
汤姆忘老啷个做	汤姆忘了怎么做
汤姆希望玛丽别死	汤姆希望玛丽别死
汤姆溜出老教室	汤姆溜出了教室
汤姆被警察盘问	汤姆被警察盘问
明天是个大日子	明天是个大日子
红绿灯一直在运作	红绿灯一直在运作
UN代表联合国	UN代表联合国
我们同意分担家务	我们同意分担家务
我们明天要切跳舞	我们明天要去跳舞
我们应该更小心的	我们应该更小心的
我们不该再对视老	我们不该再对视了
我们像澄清这个问题	我们像澄清这个问题
我们切老林中散步	我们去了林中散步
我们被两面夹击老	我们被两面夹击了
我们在等对的时机	我们在等对的时机
我们必须把你带走	我们必须把你带走
我们以前讨论过	我们以前讨论过
你父母亲在家吗	你父母亲在家吗
你今晚要做啥子	你今晚要做什么
你用那些书做啥子	你用那些书做什么
你大学时主修啥子	你大学时主修什么
汤姆想吃的是啥子	汤姆想吃的是什么
你的车子啷个老	你的车子怎么了
在埃及说啥子语言	在埃及说什么语言
您最喜欢哪个季节	您最喜欢哪个季节
当时你在做啥子	当时你在做什么
你说的莫得道理	你说的没有道理
她答应几时见他	她答应几时见他
你要切哪里吃午饭	你要去哪里吃午饭
我要在哪里换火车	我要在哪里换火车
你明天想切那里	你明天想去那里
你爷爷住在哪里	你爷爷住在哪里
你昨天上午在哪里	你昨天上午在哪里
你想先切哪里	你想先去哪里
你切过哪些国家	你去过哪些国家
这个手提箱是哪个的	这个手提箱是谁的
他明天能来吗	他明天能来吗
她明年会切美国吗	她明年会去美国吗
你明年会切美国吗	你明年会去美国吗
你今晚会切派对吗	你今晚会去派对吗
三点钟可以吗	三点钟可以吗
你要喝点啥子吗	你要喝点什么吗
你能让我看看吗	你能让我看看吗
请你把门关上好吗	请你把门关上好吗
请你帮我照相好吗	请你帮我照相好吗
你可以在地上挖土	你可以在地上挖土
你啥子也做不老	你什么也做不了
你不能处理压力	你不能处理压力
你不必这么早来	你不必这么早来
你不必快速作答	你不必快速作答
你该早一点起床	你该早一点起床
你不可以妄下结论	你不可以妄下结论
你应该准时上班	你应该准时上班
你比我记得好	你比我记得好
你应该永远说实话	你应该永远说实话
你应该重写这句话	你应该重写这句话
您应该乘5路车	您应该乘5路车
你白费力气老	你白费力气了
你的体型比我的好	你的体型比我的好
你根本莫得注意	你根本没有注意
你把帽子戴反老	你把帽子戴反了
你的父母很爱你	你的父母很爱你
一个球正顺流而下	一个球正顺流而下
在夜间发生老火灾	在夜间发生了火灾
忽然天气转为多云	忽然天气转为多云
突然开始下雨	突然开始下雨
苹果被当作甜点	苹果被当作甜点
你感觉不舒服吗	你感觉不舒服吗
做教师很辛苦	做教师很辛苦
请带一张纸给我	请带一张纸给我
你能分辨银和锡吗	你能分辨银和锡吗
在下一站换火车	在下一站换火车
十一点钟来看我	十一点钟来看我
比较你和他的翻译	比较你和他的翻译
你参观伦敦塔老吗	你参观伦敦塔了吗
我必须留在医院吗	我必须留在医院吗
你们有非吸烟区吗	你们有非吸烟区吗
你不懂基本逻辑吗	你不懂基本逻辑吗
你常常晚餐吃鱼吗	你常常晚餐吃鱼吗
你明白我的意思吗	你明白我的意思吗
你想吃点别的吗	你想吃点别的吗
你今晚想吃寿司吗	你今晚想吃寿司吗
别害怕犯错	别害怕犯错
不要被外貌蒙蔽老	不要被外貌蒙蔽了
别用铅笔签合同	别用铅笔签合同
不要扔石头到河里	不要扔石头到河里
你不想知道原因吗	你不想知道原因吗
趁汤没凉之前喝下	趁汤没凉之前喝下
爱迪生发明老电灯	爱迪生发明了电灯
英语并不难学	英语并不难学
法律面前人人平等	法律面前人人平等
一切按计划进行	一切按计划进行
目前我待在酒店	目前我待在酒店
法国在英国的南边	法国在英国的南边
知足常乐	知足常乐
你回信老吗	你回信了吗
你吃过日本料理吗	你吃过日本料理吗
他倒车入车库	他倒车入车库
他向他的朋友借钱	他向他的朋友借钱
他来自一个小山城	他来自一个小山城
他不太关注棒球	他不太关注棒球
他似乎不是美国人	他似乎不是美国人
他喝很少的水	他喝很少的水
他以教书为生	他以教书为生
他以当老师为生	他以当老师为生
他赚的比我多三倍	他赚的比我多三倍
他给老我食物和钱	他给了我食物和钱
他保守着这个秘密	他保守着这个秘密
她很懂法语	她很懂法语
他有丰富的经验	他有丰富的经验
他已经教老20年	他已经教了20年
他访问过法国三次	他访问过法国三次
他切过伦敦三次	他去过伦敦三次
他正在学啷个开车	他正在学怎么开车
他现在住在国外	他现在住在国外
他今晚会来我家	他今晚会来我家
他对结果不满意	他对结果不满意
他在战时参军	他在战时参军
他聪明到不会娶她	他聪明到不会娶她
他不会傻到切娶她	他不会傻到去娶她
他喜欢独自散步	他喜欢独自散步
他设法穿过老人群	他设法穿过了人群
他设法使收支平衡	他设法使收支平衡
他可能搭错火车老	他可能搭错火车了
他假装是一位律师	他假装是一位律师
他拒绝跟我握手	他拒绝跟我握手
他昨天从国外回来	他昨天从国外回来
他说他要一些钱	他说他要一些钱
他会讲英语和法语	他会讲英语和法语
他朝狗扔老一块肉	他朝狗扔了一块肉
他参加老奥运会	他参加了奥运会
他怕被嘲笑	他怕被嘲笑
他愿意为别人工作	他愿意为别人工作
他迟早会回来的	他迟早会回来的
他该切火车站老	他该去火车站了
他迟早会后悔	他迟早会后悔
他比你高一点点	他比你高一点点
他总是缺钱	他总是缺钱
她母亲一直陪着她	她母亲一直陪着她
他的行为值得尊重	他的行为值得尊重
他家在这儿某处	他家在这儿某处
他的房子遭到雷击	他的房子遭到雷击
他的办公室在八楼	他的办公室在八楼
喝点冷饮怎样	喝点冷饮怎样
你的姓啷个拼	你的姓怎么拼
你将在日本住多久	你将在日本住多久
你在钏路多久老	你在钏路多久了
您将在这里待多久	您将在这里待多久
一周有几天	一周有几天
你每天睡几个小时	你每天睡几个小时
你看这看老多少次	你看这看了多少次
你曾多常切过欧洲	你曾多常去过欧洲
我周日哪里也不切	我周日哪里也不去
我相信规律的运动	我相信规律的运动
我在东京站换火车	我在东京站换火车
我承认偷老钱	我承认偷了钱
我忍不住要大笑	我忍不住要大笑
我不同意他的看法	我不同意他的看法
我无法让他明白	我无法让他明白
我没做不寻常的事	我没做不寻常的事
上周一我没切上学	上周一我没去上学
我不相信鬼魂存在	我不相信鬼魂存在
我不怪你撞到他	我不怪你撞到他
我不想吃任何东西	我不想吃任何东西
我不知道你要切哪	我不知道你要去哪
我不认为她很在意	我不认为她很在意
我不想接受手术	我不想接受手术
我不想谈我自己	我不想谈我自己
我突然好想大叫	我突然好想大叫
我昨晚睡老五小时	我昨晚睡了五小时
我准时赶上老火车	我准时赶上了火车
我毕业于京都大学	我毕业于京都大学
我想这取决于天气	我想这取决于天气
我刚从学校回来	我刚从学校回来
我不想问他	我不想问他
我在厨房里帮妈妈	我在厨房里帮妈妈
我刚说老很蠢的话	我刚说了很蠢的话
我喜欢饭后散步	我喜欢饭后散步
我每晚都听收音机	我每晚都听收音机
我反对他付帐单	我反对他付帐单
我见过狗游泳渡河	我见过狗游泳渡河
我认为我能帮点忙	我认为我能帮点忙
我通常七点吃早餐	我通常七点吃早餐
我要环游世界	我要环游世界
我能回答这个问题	我能回答这个问题
昨天上午我在学校	昨天上午我在学校
该由我告诉汤姆	该由我告诉汤姆
我在晚上看电视	我在晚上看电视
早餐后我切散步老	早餐后我去散步了
我明天下午有空	我明天下午有空
我明年会住在筱山	我明年会住在筱山
我明天会付钱给你	我明天会付钱给你
我宁死不降	我宁死不降
请给我一杯水	请给我一杯水
我要一杯水谢谢	我要一杯水谢谢
我想要一楼的座位	我想要一楼的座位
我想更改我的预订	我想更改我的预订
我想吃蛋糕当点心	我想吃蛋糕当点心
我想打个国际电话	我想打个国际电话
我想付帐谢谢	我想付帐谢谢
我想在餐厅工作	我想在餐厅工作
我正忙着找公寓	我正忙着找公寓
我期待再次见到他	我期待再次见到他
我期待着见到你	我期待着见到你
我期待着您的光临	我期待着您的光临
我打算待在旅馆里	我打算待在旅馆里
很抱歉让你遭这罪	很抱歉让你遭这罪
我住在喜来登酒店	我住在喜来登酒店
我头痛得厉害	我头痛得厉害
我确定汤姆想来	我确定汤姆想来
我切过那里几次	我去过那里几次
我真的受够老她	我真的受够了她
我刚刚切老邮局	我刚刚去了邮局
我从未这么高兴	我从未这么高兴
我没听说她会来	我没听说她会来
冰岛以前属于丹麦	冰岛以前属于丹麦
酒喝太多很危险	酒喝太多很危险
弹钢琴很困难	弹钢琴很困难
我觉得这难以置信	我觉得这难以置信
这里夏天非常炎热	这里夏天非常炎热
今天比昨天暖和	今天比昨天暖和
我遇见哪个都无所谓	我遇见谁都无所谓
他似乎啥子都知道	他似乎什么都知道
你似乎错老	你似乎错了
一两天内就能结束	一两天内就能结束
让我帮您提行李	让我帮您提行李
我们等雨停吧	我们等雨停吧
玛丽通常不戴首饰	玛丽通常不戴首饰
玛丽明天会帮我们	玛丽明天会帮我们
你可以给我画张画	你可以给我画张画
我最讨厌穿船袜老	我最讨厌穿船袜了
我哥哥擅长数学	我哥哥擅长数学
我爸爸常常洗碗	我爸爸常常洗碗
我祖父九十多岁老	我祖父九十多岁了
这首歌老少皆宜	这首歌老少皆宜
打牌很有意思	打牌很有意思
请小心不要受伤老	请小心不要受伤了
请不要那样看我	请不要那样看我
欢迎随时提问	欢迎随时提问
请给我些饮料喝	请给我些饮料喝
请帮我填这张表格	请帮我填这张表格
请随意吃水果	请随意吃水果
请讲慢一点	请讲慢一点
请好好照顾你自己	请好好照顾你自己
请带我到大饭店	请带我到大饭店
请告诉我你的问题	请告诉我你的问题
请稍等一会儿	请稍等一会儿
请在车站等我	请在车站等我
她立刻回信给我	她立刻回信给我
她请他寄那封信	她请他寄那封信
她不想吃午饭	她不想吃午饭
她不想提老	她不想提了
她摸索着一张纸	她摸索着一张纸
她在超市做秘书	她在超市做秘书
她的母语是法语	她的母语是法语
她渴望住在澳洲	她渴望住在澳洲
她让他等老半小时	她让他等了半小时
她让我等老半小时	她让我等了半小时
她弹吉他他唱歌	她弹吉他他唱歌
她每天练习弹钢琴	她每天练习弹钢琴
她把杂志放在桌上	她把杂志放在桌上
晚饭后她读日语	晚饭后她读日语
她教我如何写诗	她教我如何写诗
她走来走切地找他	她走来走去地找他
她想在医院工作	她想在医院工作
她和她母亲切购物	她和她母亲去购物
她独自切看老电影	她独自去看了电影
游泳使腿部强健	游泳使腿部强健
深呼吸然后放松	深呼吸然后放松
起飞比降落容易	起飞比降落容易
教师必须老解孩子	教师必须了解孩子
告诉她我在做晚饭	告诉她我在做晚饭
告诉他别多管閒事	告诉他别多管閒事
非常谢谢你的礼物	非常谢谢你的礼物
那药不会管用	那药不会管用
这条河汇入太平洋	这条河汇入太平洋
新娘好像非常漂亮	新娘好像非常漂亮
火灾的原因不明	火灾的原因不明
公司取消老会议	公司取消了会议
这是湖的最深处	这是湖的最深处
会议将于明天举行	会议将于明天举行
这座山被雪复盖老	这座山被雪复盖了
油漆从墙上脱落	油漆从墙上脱落
停车场是免费的	停车场是免费的
药局在医院附近	药局在医院附近
天上满是飞机	天上满是飞机
小偷带着钱逃跑老	小偷带着钱逃跑了
厕所冲水不正常	厕所冲水不正常
火车挤满老人	火车挤满了人
风从东方吹来	风从东方吹来
有许多濒危物种	有许多濒危物种
公园里有很多人	公园里有很多人
罐子里有一些饼干	罐子里有一些饼干
房里有个电视机	房里有个电视机
昨晚下大雨	昨晚下大雨
计划突然改变	计划突然改变
莫得重建的钱	没有重建的钱
几乎没剩下钱	几乎没剩下钱
莫得人在家	没有人在家
湖上有一些船	湖上有一些船
对街有一家旅馆	对街有一家旅馆
我对此无能为力	我对此无能为力
这些玩具适合女生	这些玩具适合女生
他们要他作队长	他们要他作队长
这里只卖女鞋	这里只卖女鞋
他们应该十点前到	他们应该十点前到
他们全部穿制服老	他们全部穿制服了
事情要失控老	事情要失控了
这张书桌比那张好	这张书桌比那张好
这班火车每站都停	这班火车每站都停
这项工作未必容易	这项工作未必容易
汤姆尽量避开玛丽	汤姆尽量避开玛丽
汤姆常来这里	汤姆常来这里
汤姆昨晚没吃晚餐	汤姆昨晚没吃晚餐
汤姆莫得微波炉	汤姆没有微波炉
汤姆一般不吃早饭	汤姆一般不吃早饭
汤姆不想谈这件事	汤姆不想谈这件事
汤姆经常说梦话	汤姆经常说梦话
汤姆今早出发晚老	汤姆今早出发晚了
汤姆最近相当忙	汤姆最近相当忙
汤姆是我的远亲	汤姆是我的远亲
汤姆总是在看电视	汤姆总是在看电视
汤姆喜欢折纸飞机	汤姆喜欢折纸飞机
汤姆假装没听见	汤姆假装没听见
汤姆意识到该走老	汤姆意识到该走了
汤姆通常不犯错	汤姆通常不犯错
汤姆的目的很明显	汤姆的目的很明显
火山灰阻碍航运	火山灰阻碍航运
在这附近当心小偷	在这附近当心小偷
我们喜欢听音乐	我们喜欢听音乐
我们喜欢一起唱歌	我们喜欢一起唱歌
今天早上下厚霜老	今天早上下厚霜了
今天早上天气严寒	今天早上天气严寒
我们要紧追	我们要紧追
我们马上就切做	我们马上就去做
我们外出老三个月	我们外出了三个月
晚餐吃鱼啷个样	晚餐吃鱼怎么样
你明天要做啥子	你明天要做什么
你第一节课上啥子	你第一节课上什么
你认为这是啥子	你认为这是什么
你周日通常做啥子	你周日通常做什么
这周放啥子电影	这周放什么电影
你胡说啥子呢	你胡说什么呢
你朋友几点钟回家	你朋友几点钟回家
你几点钟切学校	你几点钟去学校
你啥子时候吃早餐	你什么时候吃早餐
你啥子时候要结婚	你什么时候要结婚
水结冻后变成冰	水结冻后变成冰
你何时会回学校	你何时会回学校
你家里哪个做饭	你家里谁做饭
你想再要杯茶吗	你想再要杯茶吗
你想要来些炒蛋吗	你想要来些炒蛋吗
你要留言吗	你要留言吗
你介意我关窗户吗	你介意我关窗户吗
你介意打开窗户吗	你介意打开窗户吗
请您稍后再来好吗	请您稍后再来好吗
你不必为我买啥子	你不必为我买什么
你周日不必工作	你周日不必工作
你别嘲弄他们	你别嘲弄他们
你应该要更小心的	你应该要更小心的
你该留在车里	你该留在车里
你是有所有钱的人	你是有所有钱的人
你已经尽力老	你已经尽力了
你有很好的幽默感	你有很好的幽默感
一群年轻人在打架	一群年轻人在打架
你把功课做完老吗	你把功课做完了吗
亚洲比澳洲大很多	亚洲比澳洲大很多
进攻是最好的防御	进攻是最好的防御
伯恩是瑞士首都	伯恩是瑞士首都
樱花非常漂亮	樱花非常漂亮
选你最喜欢的颜色	选你最喜欢的颜色
用湿布清洁窗户	用湿布清洁窗户
你有带雨伞吗	你有带雨伞吗
你寒假过得愉快吗	你寒假过得愉快吗
你切年住在筱山吗	你去年住在筱山吗
你周六有啥子计划	你周六有什么计划
你有事想对我说吗	你有事想对我说吗
不要忘老关灯	不要忘了关灯
别让他玩你的手机	别让他玩你的手机
你已经按门铃老吗	你已经按门铃了吗
你吃过晚饭老吗	你吃过晚饭了吗
你读完这本书老吗	你读完这本书了吗
他一直想学日语	他一直想学日语
他7点到老火车站	他7点到了火车站
他及时赶到老会议	他及时赶到了会议
他否认打破老窗口	他否认打破了窗口
他毕业于东京大学	他毕业于东京大学
他至少有一千本书	他至少有一千本书
他学老两个小时	他学了两个小时
他是非不分	他是非不分
他会说五种语言	他会说五种语言
他不是很擅长数学	他不是很擅长数学
他为这个事故负责	他为这个事故负责
他偶尔逃学	他偶尔逃学
他喜欢照顾花园	他喜欢照顾花园
他住在松江七年老	他住在松江七年了
他住在我们街对面	他住在我们街对面
他环游世界旅行	他环游世界旅行
他从未看不起穷人	他从未看不起穷人
他通过老入学考试	他通过了入学考试
他跑得比他哥哥快	他跑得比他哥哥快
他放火烧老校舍	他放火烧了校舍
他学习现代文学	他学习现代文学
他及时赴约老	他及时赴约了
他不善于记人名	他不善于记人名
他是委员会主席	他是委员会主席
他比我高三英寸	他比我高三英寸
他垒球打得很好	他垒球打得很好
随你喜欢随便吃	随你喜欢随便吃
他的声音很悦耳	他的声音很悦耳
他老婆很有才	他老婆很有才
今晚出切吃啷个样	今晚出去吃怎么样
我在冬季总是感冒	我在冬季总是感冒
我相信他是无辜的	我相信他是无辜的
我明天会切打网球	我明天会去打网球
我期待见到你	我期待见到你
我在写演讲的草稿	我在写演讲的草稿
我向一个警察问路	我向一个警察问路
我不喜欢住在乡下	我不喜欢住在乡下
稍微冷一点没关系	稍微冷一点没关系
天气热点儿没关系	天气热点儿没关系
我不认为汤姆明白	我不认为汤姆明白
今天我不想切教堂	今天我不想去教堂
我不想听你的理论	我不想听你的理论
我想吃点甜的东西	我想吃点甜的东西
我有很多朋友帮我	我有很多朋友帮我
我今年没做多少事	我今年没做多少事
我还没做完作业	我还没做完作业
我帮妈妈洗碗老	我帮妈妈洗碗了
晚饭后我听收音机	晚饭后我听收音机
我把书还给图书馆	我把书还给图书馆
我还没完成作业	我还没完成作业
我每天搭火车上班	我每天搭火车上班
我认为她要杀我	我认为她要杀我
我想做一个程序员	我想做一个程序员
我想让你再呆一会	我想让你再呆一会
我能找到他的地址	我能找到他的地址
我正要切写一封信	我正要去写一封信
我在说别的事	我在说别的事
我昨天切看老电影	我昨天去看了电影
我明天会给你钱	我明天会给你钱
我希望她戒烟	我希望她戒烟
我会尽快完成的	我会尽快完成的
我切过澳洲三次	我去过澳洲三次
我已经浇完花老	我已经浇完花了
要收服务费吗	要收服务费吗
厨房里有咖啡吗	厨房里有咖啡吗
有哪个可以帮我吗	有谁可以帮我吗
戒烟很难	戒烟很难
天看起来要下雨老	天看起来要下雨了
雪持续下老十天	雪持续下了十天
昨天早上很冷	昨天早上很冷
很遗憾你不能来	很遗憾你不能来
从昨晚起一直下雨	从昨晚起一直下雨
那里连夏天都很冷	那里连夏天都很冷
弥补永远不会太晚	弥补永远不会太晚
到村庄只有两英里	到村庄只有两英里
这里夏天非常热	这里夏天非常热
学英语需要耐性	学英语需要耐性
让我看看那些照片	让我看看那些照片
再需要我就告诉我	再需要我就告诉我
让我们明年再相聚	让我们明年再相聚
现在长裙过时老	现在长裙过时了
现在长裙不流行老	现在长裙不流行了
许多工人死于饥饿	许多工人死于饥饿
许多小公司倒闭老	许多小公司倒闭了
我爸爸周日上教堂	我爸爸周日上教堂
我父亲感冒老	我父亲感冒了
我心里充满着快乐	我心里充满着快乐
我的房子就在对街	我的房子就在对街
我母亲教插花艺术	我母亲教插花艺术
我妈妈每天洗衣服	我妈妈每天洗衣服
我和妹妹切老城堡	我和妹妹去了城堡
不要害怕犯错	不要害怕犯错
所有的电话都不通	所有的电话都不通
我国是温带气候	我国是温带气候
我校校长很老老	我校校长很老了
请回答我这个问题	请回答我这个问题
请向服务台询问	请向服务台询问
请尽情地跳舞	请尽情地跳舞
请你随便吃点水果	请你随便吃点水果
请记得把信寄出切	请记得把信寄出去
请明天前还书	请明天前还书
请仔细洗牌	请仔细洗牌
请看看这张照片	请看看这张照片
请你把冷气调高点	请你把冷气调高点
她指责我犯老错	她指责我犯了错
她倒车进车库	她倒车进车库
她用拳头拍老桌子	她用拳头拍了桌子
她抱怨我的工资低	她抱怨我的工资低
起初她不喜欢马	起初她不喜欢马
她似乎不是美国人	她似乎不是美国人
她在家不说日语	她在家不说日语
她挤上老火车	她挤上了火车
她延长停留五天	她延长停留五天
她多停留老五天	她多停留了五天
她亲自过问老此事	她亲自过问了此事
她毕业于神户大学	她毕业于神户大学
她今晚离开切美国	她今晚离开去美国
她非常周到和耐心	她非常周到和耐心
她设法保住面子	她设法保住面子
她骂她的儿子懒惰	她骂她的儿子懒惰
她会讲英语和法语	她会讲英语和法语
她上午学习英语	她上午学习英语
她通常睡八个小时	她通常睡八个小时
她昨天切老医院	她昨天去了医院
她大概跟你一样高	她大概跟你一样高
她擅于逃避规则	她擅于逃避规则
她在花园里种玫瑰	她在花园里种玫瑰
在火车上禁止吸烟	在火车上禁止吸烟
有些事不做更好	有些事不做更好
显然有人在撒谎	显然有人在撒谎
刹车出老问题	刹车出了问题
第一条街右转	第一条街右转
教英语是他的职业	教英语是他的职业
谢谢你告诉我真相	谢谢你告诉我真相
我先谢谢你的帮忙	我先谢谢你的帮忙
那个相当能说得通	那个相当能说得通
这座山被雪所覆盖	这座山被雪所覆盖
那女人比我老很多	那女人比我老很多
小男孩跑进老房间	小男孩跑进了房间
这个男孩不懂礼貌	这个男孩不懂礼貌
这个男孩喜欢绘画	这个男孩喜欢绘画
男孩躺着听收音机	男孩躺着听收音机
小孩们在玩玩具	小孩们在玩玩具
九点钟锁门	九点钟锁门
花园里充满老花朵	花园里充满了花朵
猎人射死老狐狸	猎人射死了狐狸
图书馆在二楼	图书馆在二楼
这座山被雪覆盖着	这座山被雪覆盖着
该病人正逐步康复	该病人正逐步康复
那幅图挂在墙上	那幅图挂在墙上
画挂在墙上	画挂在墙上
飞机十分钟后起飞	飞机十分钟后起飞
行星绕着太阳转	行星绕着太阳转
警察逮捕老小偷	警察逮捕了小偷
警察逮捕老窃贼	警察逮捕了窃贼
邮局在街那头	邮局在街那头
王子继承老王位	王子继承了王位
校长想跟你谈话	校长想跟你谈话
囚犯重获自由	囚犯重获自由
这个节目九点开始	这个节目九点开始
火箭发射进入太空	火箭发射进入太空
街道上挤满老人	街道上挤满了人
火车该在中午到	火车该在中午到
双方本周举行会谈	双方本周举行会谈
七月天气经常很热	七月天气经常很热
风从北边来	风从北边来
伦敦有很多公园	伦敦有很多公园
每条规则都有例外	每条规则都有例外
我家有四个人	我家有四个人
一年有四季	一年有四季
港口内有许多船	港口内有许多船
树下有一些男孩	树下有一些男孩
桌子上只有一本书	桌子上只有一本书
这口井里的水很少	这口井里的水很少
沙滩上的人非常少	沙滩上的人非常少
到村庄有条窄路	到村庄有条窄路
现在建筑里没人	现在建筑里没人
这汤里盐放多老	这汤里盐放多了
这些画是他画的	这些画是他画的
他们相信来世	他们相信来世
他们选出老新政府	他们选出了新政府
他们经常切欧洲	他们经常去欧洲
他们昨天路过她家	他们昨天路过她家
据说老房子闹鬼	据说老房子闹鬼
这辆车很省油	这辆车很省油
这要花很多钱	这要花很多钱
这是日本最高的塔	这是日本最高的塔
这是他出生的城市	这是他出生的城市
那些图画是他画的	那些图画是他画的
数千人死于饥饿	数千人死于饥饿
汤姆和玛丽等烦老	汤姆和玛丽等烦了
Tom否认偷老钱	Tom否认偷了钱
汤姆不知所措	汤姆不知所措
汤姆爱玛丽很久老	汤姆爱玛丽很久了
汤姆就不该做那事	汤姆就不该做那事
汤姆可能想切游泳	汤姆可能想去游泳
汤姆学老三年法语	汤姆学了三年法语
汤姆吓得说不出话	汤姆吓得说不出话
交通被山崩所阻断	交通被山崩所阻断
我们很节省地旅行	我们很节省地旅行
昨晚雨势很大	昨晚雨势很大
我们到达老山顶	我们到达了山顶
我们聊到凌晨两点	我们聊到凌晨两点
你最喜欢啥子科目	你最喜欢什么科目
你每天几点起床	你每天几点起床
你喜欢吃啥子菜	你喜欢吃什么菜
你今天午餐吃啥子	你今天午餐吃什么
芬兰的首都是啥子	芬兰的首都是什么
你的行李多重	你的行李多重
早饭在何时何地用	早饭在何时何地用
你何时要戒烟	你何时要戒烟
雨季何时会结束	雨季何时会结束
哪个负责今天的派对	谁负责今天的派对
你昨天为甚么在家	你昨天为甚么在家
你为何周六没来	你为何周六没来
他能赶上火车吗	他能赶上火车吗
你要喝点咖啡吗	你要喝点咖啡吗
请你等一哈好吗	请你等一下好吗
你要对结果负责	你要对结果负责
你对批评太敏感老	你对批评太敏感了
你不明白程序	你不明白程序
你最好切看牙医	你最好去看牙医
你没啥子可抱歉的	你没什么可抱歉的
你该安静几天	你该安静几天
你该考虑他的年纪	你该考虑他的年纪
你该告诉汤姆	你该告诉汤姆
患难见真情	患难见真情
天下无不散之筵席	天下无不散之筵席
你要参加会议吗	你要参加会议吗
已经安排好老	已经安排好了
你会开手排车吗	你会开手排车吗
牛在牧地上吃草	牛在牧地上吃草
不要把本末倒置	不要把本末倒置
自助者天助	自助者天助
你买彩票老吗	你买彩票了吗
你读完那本书老吗	你读完那本书了吗
他看起来健康强壮	他看起来健康强壮
他无法理解这句话	他无法理解这句话
他从架上拿下书	他从架上拿下书
他切过夏威夷几次	他去过夏威夷几次
他怕得到肺癌	他怕得到肺癌
他擅长应付小孩子	他擅长应付小孩子
他善用老这个机会	他善用了这个机会
他说很可能会下雨	他说很可能会下雨
他游到不能游为止	他游到不能游为止
他昨天没来上学	他昨天没来上学
我啷个切警察局	我怎么去警察局
你住在筱山多久老	你住在筱山多久了
那张木椅要多少钱	那张木椅要多少钱
我学两种外语	我学两种外语
我买不起自行车	我买不起自行车
我莫得参与对话	我没有参与对话
我不是很想出切	我不是很想出去
我不在乎将来	我不在乎将来
我不记得寄过信老	我不记得寄过信了
我不想跟你交朋友	我不想跟你交朋友
我不想再听到这事	我不想再听到这事
我早上不洗头	我早上不洗头
我在法国认识老她	我在法国认识了她
我在法国认识老他	我在法国认识了他
我免费得到溜冰鞋	我免费得到溜冰鞋
我收集很多邮票	我收集很多邮票
我决定继续工作	我决定继续工作
我确定没人跟踪我	我确定没人跟踪我
我设法让他明白老	我设法让他明白了
我以为你想见我呢	我以为你想见我呢
我试着阻止它发生	我试着阻止它发生
我那时还是个外行	我那时还是个外行
我在吃午饭前洗手	我在吃午饭前洗手
我想复习英语	我想复习英语
我想买些靴子	我想买些靴子
我想兑换旅行支票	我想兑换旅行支票
我想请你参加派对	我想请你参加派对
我想让你下周回来	我想让你下周回来
我的白发越来越多	我的白发越来越多
我下一站下车	我下一站下车
我会在下一站下车	我会在下一站下车
我早上切见汤姆	我早上去见汤姆
我有点不安	我有点不安
我准备再前进一点	我准备再前进一点
用筷子吃饭难吗	用筷子吃饭难吗
这是你找的钥匙吗	这是你找的钥匙吗
众口难调	众口难调
你有必要到那里切	你有必要到那里去
他这么说很奇怪	他这么说很奇怪
今天也好像会下雨	今天也好像会下雨
不可能找得到答案	不可能找得到答案
韩国菜一般都很辣	韩国菜一般都很辣
京都以古庙有名	京都以古庙有名
学游泳非常简单	学游泳非常简单
我的公寓在四楼	我的公寓在四楼
我哥哥是个高中生	我哥哥是个高中生
爸爸准许我切游泳	爸爸准许我去游泳
我姐姐比我哥哥大	我姐姐比我哥哥大
长不高不是坏事	长不高不是坏事
老人时常自言自语	老人时常自言自语
张开嘴巴闭上眼睛	张开嘴巴闭上眼睛
观点因人而异	观点因人而异
请不要告诉你父母	请不要告诉你父母
请用挂号寄这个	请用挂号寄这个
请你将来注意点	请你将来注意点
以后请注意点	以后请注意点
罗马有很多古建筑	罗马有很多古建筑
她莫得驾照	她没有驾照
她有咬指甲的习惯	她有咬指甲的习惯
她大病初愈	她大病初愈
她很惊讶他出现老	她很惊讶他出现了
她明年将要结婚	她明年将要结婚
整天坐着对你不好	整天坐着对你不好
有些人很难取悦	有些人很难取悦
有人站在墙后	有人站在墙后
谢谢你为我画鸟	谢谢你为我画鸟
谢谢你邀请我吃饭	谢谢你邀请我吃饭
那个发现纯属偶然	那个发现纯属偶然
这需要慎重考虑	这需要慎重考虑
船被用短绳系着	船被用短绳系着
医生马上就来	医生马上就来
医生在观察X光片	医生在观察X光片
考试分为两个部分	考试分为两个部分
灯由红变绿	灯由红变绿
问题还莫得解决	问题还没有解决
老人几乎被车撞上	老人几乎被车撞上
自动售货机在那边	自动售货机在那边
浪拍在岩石上	浪拍在岩石上
日本有许多地震	日本有许多地震
篮子里有一些苹果	篮子里有一些苹果
两者莫得关联	两者没有关联
这里以前有个商店	这里以前有个商店
这里曾是座旧庙	这里曾是座旧庙
公园里有一大群人	公园里有一大群人
房间里几乎莫得人	房间里几乎没有人
这两个词容易混淆	这两个词容易混淆
这支铅笔比那只好	这支铅笔比那只好
这个字很难发音	这个字很难发音
数千人失业	数千人失业
汤姆莫得驾驶证	汤姆没有驾驶证
汤姆填写老申请表	汤姆填写了申请表
汤姆对我一直很好	汤姆对我一直很好
Tom刚吃完晚饭	Tom刚吃完晚饭
汤姆在给玛丽买花	汤姆在给玛丽买花
汤姆对登山感兴趣	汤姆对登山感兴趣
水结冰后成为固体	水结冰后成为固体
我们通常饭后喝茶	我们通常饭后喝茶
我们应该废除死刑	我们应该废除死刑
我们谈老各种话题	我们谈了各种话题
你到底在谈啥子	你到底在谈什么
你星期天几点起床	你星期天几点起床
爆炸的原因是啥子	爆炸的原因是什么
有志者事竟成	有志者事竟成
你选哪个当总统	你选谁当总统
你能借我些钱吗	你能借我些钱吗
你不用马上回答	你不用马上回答
限你三分钟内投降	限你三分钟内投降
你应该早点来的	你应该早点来的
你看来在等人	你看来在等人
你应该提前付租金	你应该提前付租金
你应该来跟我说	你应该来跟我说
笨蛋难聚财	笨蛋难聚财
所有的学生都拍手	所有的学生都拍手
这里允许拍照吗	这里允许拍照吗
你是个高中生吗	你是个高中生吗
你正确地刷牙吗	你正确地刷牙吗
情人眼里出西施	情人眼里出西施
上床睡觉前要刷牙	上床睡觉前要刷牙
警察找到指纹老吗	警察找到指纹了吗
你的胃会痛吗	你的胃会痛吗
生菜要洗吗	生菜要洗吗
不要探听别人的事	不要探听别人的事
英语是国际语言	英语是国际语言
上帝创造老天地	上帝创造了天地
他刚好准时到校	他刚好准时到校
他乘小船过河	他乘小船过河
他每天切学校学习	他每天去学校学习
他熟悉日本文化	他熟悉日本文化
他在意外中失明老	他在意外中失明了
他站在街角	他站在街角
他切美国学医老	他去美国学医了
你一个月读几本书	你一个月读几本书
一公斤香蕉多少钱	一公斤香蕉多少钱
我对这附近很熟悉	我对这附近很熟悉
我在下一站下车	我在下一站下车
我很关心他的健康	我很关心他的健康
我用12美元买的	我用12美元买的
我不能忍着不笑	我不能忍着不笑
这一点我不赞成你	这一点我不赞成你
我讨厌那种事	我讨厌那种事
我昨晚认识老他	我昨晚认识了他
我跟这件事无关	我跟这件事无关
我跟你哥哥很熟	我跟你哥哥很熟
我赢得老我想要的	我赢得了我想要的
我高中时曾打网球	我高中时曾打网球
我今年不结婚	我今年不结婚
我想要一杯咖啡	我想要一杯咖啡
我想喝一杯咖啡	我想喝一杯咖啡
我下个月要休假	我下个月要休假
我不是个初中生	我不是个初中生
我很惊讶你得老奖	我很惊讶你得了奖
我厌倦老听他吹嘘	我厌倦了听他吹嘘
我一直想登富士山	我一直想登富士山
说英语不难	说英语不难
很遗憾他们离婚老	很遗憾他们离婚了
猴子爬树容易	猴子爬树容易
学外文很无聊	学外文很无聊
我爸爸帮我做作业	我爸爸帮我做作业
我妈妈让我吃点药	我妈妈让我吃点药
她的悲伤无法言喻	她的悲伤无法言喻
请在三天内回来	请在三天内回来
请尽快回来	请尽快回来
放点盐到滚水里	放点盐到滚水里
她声称自己没罪	她声称自己没罪
她说他不会戒烟	她说他不会戒烟
她几乎不说英语	她几乎不说英语
她想洗脏衣服	她想洗脏衣服
她年轻时很美丽	她年轻时很美丽
她急于见她的父亲	她急于见她的父亲
她不如她姊姊漂亮	她不如她姊姊漂亮
她是啃老族	她是啃老族
您下午做啥呢	您下午做啥呢
她可能出啥子事老	她可能出什么事了
搭乘电梯到五楼	搭乘电梯到五楼
这棵大树遭到雷击	这棵大树遭到雷击
书架和桌子齐平	书架和桌子齐平
大爆炸致死六人	大爆炸致死六人
这小男孩怕黑	这小男孩怕黑
会议比往常早结束	会议比往常早结束
花瓣浮在水面上	花瓣浮在水面上
铁路与公路平行	铁路与公路平行
蛋壳容易破碎	蛋壳容易破碎
情况越来越糟糕	情况越来越糟糕
气温突然下降老	气温突然下降了
桥对面有一间小屋	桥对面有一间小屋
我的车子有问题	我的车子有问题
我的车子故障老	我的车子故障了
一定有解决的办法	一定有解决的办法
我钱包里没钱老	我钱包里没钱了
在转角有一家酒吧	在转角有一家酒吧
赢的机会微乎其微	赢的机会微乎其微
他不可能来	他不可能来
他们渡河前进	他们渡河前进
他这个时候该到老	他这个时候该到了
那两个小孩同岁	那两个小孩同岁
汤姆在镜前练习	汤姆在镜前练习
汤姆看来比我高兴	汤姆看来比我高兴
汤姆想学唱法语歌	汤姆想学唱法语歌
汤姆对结果不满	汤姆对结果不满
汤姆穿着一双旧鞋	汤姆穿着一双旧鞋
我们正要进房间	我们正要进房间
我们难以找到汤姆	我们难以找到汤姆
哪个负责销售部门	谁负责销售部门
想报警的是哪个	想报警的是谁
你想再来杯酒吗	你想再来杯酒吗
请你再说一次好吗	请你再说一次好吗
你可以再说一次吗	你可以再说一次吗
昨天天气不是很好	昨天天气不是很好
昨天天气非常好	昨天天气非常好
你不怕鬼不是么	你不怕鬼不是么
你昨天没来学校	你昨天没来学校
你没必要待到最后	你没必要待到最后
你不妨告诉我一切	你不妨告诉我一切
你应该对邻居好点	你应该对邻居好点
明天你可以看到他	明天你可以看到他
你绝对确定这事吗	你绝对确定这事吗
十一点准时到车站	十一点准时到车站
能再告诉我一点吗	能再告诉我一点吗
请您再说一遍好吗	请您再说一遍好吗
你有除锈的东西吗	你有除锈的东西吗
你经常早餐喝茶吗	你经常早餐喝茶吗
列车停下前别下车	列车停下前别下车
世界各地都读英语	世界各地都读英语
你曾经得过重病吗	你曾经得过重病吗
他面临着许多困难	他面临着许多困难
他玩股票赔老	他玩股票赔了
他在班上出类拔萃	他在班上出类拔萃
他反对种族歧视	他反对种族歧视
他的发音远非完美	他的发音远非完美
这个班有多少男生	这个班有多少男生
他家里有几口人	他家里有几口人
只要你开心就行老	只要你开心就行了
我没时间跟您碰头	我没时间跟您碰头
我今天不想买报纸	我今天不想买报纸
我不知道穿甚么好	我不知道穿甚么好
我明天得早起	我明天得早起
我刚跟主管人谈过	我刚跟主管人谈过
我昨晚睡得很晚	我昨晚睡得很晚
我在等事情发生	我在等事情发生
我想跟你私下说话	我想跟你私下说话
我想谈谈你的情况	我想谈谈你的情况
我厌倦老这种生活	我厌倦了这种生活
他有可能辞职吗	他有可能辞职吗
很难把中文说得好	很难把中文说得好
日本的夏天很热	日本的夏天很热
携带武器是违法的	携带武器是违法的
因为你我们才迟老	因为你我们才迟了
你求他帮忙莫得用	你求他帮忙没有用
京都依赖旅游业	京都依赖旅游业
看那边那幢高楼	看那边那幢高楼
只有一人倖免于难	只有一人倖免于难
也许下午会下雨	也许下午会下雨
她给她妈妈打电话	她给她妈妈打电话
她裁布做绷带	她裁布做绷带
她一直哭哭啼啼	她一直哭哭啼啼
她照顾可怜的小鸟	她照顾可怜的小鸟
有人穿错老我的鞋	有人穿错了我的鞋
有人拿错老我的鞋	有人拿错了我的鞋
那是我妹妹的照片	那是我妹妹的照片
船逆流航行	船逆流航行
木匠带着他的工具	木匠带着他的工具
明天举行典礼	明天举行典礼
电梯好像故障老	电梯好像故障了
这件事他铭记于心	这件事他铭记于心
蝴蝶的寿命短	蝴蝶的寿命短
汽车的数量在增长	汽车的数量在增长
情况比我想的还坏	情况比我想的还坏
他赢的机会极小	他赢的机会极小
昨晚有一场大地震	昨晚有一场大地震
演唱会上有许多人	演唱会上有许多人
还有几间空房	还有几间空房
参加不用会员费	参加不用会员费
这件事真难处理	这件事真难处理
这部小说很难读懂	这部小说很难读懂
汤姆比玛丽大三岁	汤姆比玛丽大三岁
汤姆阻止我进银行	汤姆阻止我进银行
等到灯变为绿色	等到灯变为绿色
我们要读很多书	我们要读很多书
你今天几点起的床	你今天几点起的床
你几点会到车站	你几点会到车站
你想吃啥子作晚餐	你想吃什么作晚餐
你从哪里照的相	你从哪里照的相
请你让门开着好吗	请你让门开着好吗
你无权进入那里	你无权进入那里
你不需要考试	你不需要考试
一知半解很危险	一知半解很危险
八点半开始上课	八点半开始上课
请你分开包装好吗	请你分开包装好吗
别忘老带上急救箱	别忘了带上急救箱
明天肯定会下雨	明天肯定会下雨
得寸进尺	得寸进尺
他再也忍不住气老	他再也忍不住气了
他和他的员工相处	他和他的员工相处
他的意见不值得听	他的意见不值得听
今晚看电影啷个样	今晚看电影怎么样
我不想听汤姆唱歌	我不想听汤姆唱歌
我觉得这没啥子好	我觉得这没什么好
我不想再惹事老	我不想再惹事了
我不想谈论天气	我不想谈论天气
我有些钱	我有些钱
目前我问题很多	目前我问题很多
我认为我能做好	我认为我能做好
我乘电梯上三楼	我乘电梯上三楼
我通常在晚上洗澡	我通常在晚上洗澡
那我明天会问他的	那我明天会问他的
我希望汤姆能同意	我希望汤姆能同意
我想再要一杯咖啡	我想再要一杯咖啡
我想明天下午见他	我想明天下午见他
我要摆脱这一切	我要摆脱这一切
我不习惯早起	我不习惯早起
我现在不特别渴	我现在不特别渴
再不走就迟到老	再不走就迟到了
你还能告诉我甚么	你还能告诉我甚么
你很幸运找到老它	你很幸运找到了它
嫉妒是谋杀的动机	嫉妒是谋杀的动机
玛丽切环游世界老	玛丽去环游世界了
我爸快四十老	我爸快四十了
我妈妈早上早起	我妈妈早上早起
洋葱比马铃薯快熟	洋葱比马铃薯快熟
一些人用手吃寿司	一些人用手吃寿司
讲外语是不容易的	讲外语是不容易的
突然就下起老大雨	突然就下起了大雨
谢谢你答应来见我	谢谢你答应来见我
事故发生在转角	事故发生在转角
白天变得越来越长	白天变得越来越长
这幅画远看更好	这幅画远看更好
警方正在调查	警方正在调查
总统很难接近	总统很难接近
记者批评老政治家	记者批评了政治家
售价用红墨水写	售价用红墨水写
列车在晚上很挤	列车在晚上很挤
哄堂大笑	哄堂大笑
医生甚么也做不老	医生甚么也做不了
这些产品质量同等	这些产品质量同等
这房间有两个衣橱	这房间有两个衣橱
这个东西很有价值	这个东西很有价值
汤姆说法语不太好	汤姆说法语不太好
你能再给我点茶吗	你能再给我点茶吗
你不必带你的伞	你不必带你的伞
你不必要呆在医院	你不必要呆在医院
你最好随身带把伞	你最好随身带把伞
你不应该待在这里	你不应该待在这里
你的手表比我的贵	你的手表比我的贵
你有朋友是医生吗	你有朋友是医生吗
不要笑他犯老错误	不要笑他犯了错误
每年滨松有风筝节	每年滨松有风筝节
英语已经普及全国	英语已经普及全国
父亲将会接受手术	父亲将会接受手术
万幸没乘客受伤	万幸没乘客受伤
他对她一见锺情	他对她一见锺情
他有强烈的责任感	他有强烈的责任感
他莫得他弟弟聪明	他没有他弟弟聪明
他认为这像个鸟笼	他认为这像个鸟笼
他是聪明能干的人	他是聪明能干的人
他完全沉浸在书里	他完全沉浸在书里
他跟我想的不一样	他跟我想的不一样
日本有多少个县	日本有多少个县
您想要多少工资	您想要多少工资
我预料会有麻烦	我预料会有麻烦
我差点被卡车撞上	我差点被卡车撞上
我今天不想吃东西	我今天不想吃东西
我为老师擦黑板	我为老师擦黑板
我看老他一段时间	我看了他一段时间
我更喜欢用手写信	我更喜欢用手写信
我打心底里感激你	我打心底里感激你
我想买几副墨镜	我想买几副墨镜
我期待再见到你	我期待再见到你
我刚从邮局回来	我刚从邮局回来
有甚么事要做吗	有甚么事要做吗
你必须马上行动	你必须马上行动
您必须马上行动	您必须马上行动
他的理论很难懂	他的理论很难懂
远离电器设备	远离电器设备
闭嘴看着	闭嘴看着
玛丽帮她母亲做饭	玛丽帮她母亲做饭
不只是钱关系重大	不只是钱关系重大
我对日文不大老解	我对日文不大了解
我们学校在市中心	我们学校在市中心
恐怖片会吓到小孩	恐怖片会吓到小孩
她很尊重她的导师	她很尊重她的导师
她很善于砍价	她很善于砍价
短裙已经过时老	短裙已经过时了
短裙已经不流行老	短裙已经不流行了
那人甚么也不想做	那人甚么也不想做
该建筑高一百公尺	该建筑高一百公尺
货船早到老四小时	货船早到了四小时
教堂位于山脚	教堂位于山脚
客厅紧邻着餐厅	客厅紧邻着餐厅
这句句子意思模糊	这句句子意思模糊
警官逮捕老窃贼	警官逮捕了窃贼
雨点打着窗户	雨点打着窗户
报名时间已经过老	报名时间已经过了
图书馆里有很多书	图书馆里有很多书
日本有很多温泉	日本有很多温泉
地球上有七大洲	地球上有七大洲
测速的方法有很多	测速的方法有很多
车站前有个银行	车站前有个银行
我们有些事要谈	我们有些事要谈
他们住在路对面	他们住在路对面
这药会让你好受点	这药会让你好受点
汤姆想切还欠的钱	汤姆想去还欠的钱
我们国家不缺石油	我们国家不缺石油
夜晚很长不是吗	夜晚很长不是吗
你以后想当啥子呢	你以后想当什么呢
以后打算干啥子	以后打算干什么
你说的莫得意义	你说的没有意义
游客谘询处在哪里	游客谘询处在哪里
请您等几分钟好吗	请您等几分钟好吗
电池要额外付钱	电池要额外付钱
你该戒烟戒酒老	你该戒烟戒酒了
你将无法赶上火车	你将无法赶上火车
你最好立刻剪头发	你最好立刻剪头发
你要南辕北辙老	你要南辕北辙了
您能教我弹钢琴吗	您能教我弹钢琴吗
外交官有多种特权	外交官有多种特权
鱼和红酒不合	鱼和红酒不合
初生之犊不畏虎	初生之犊不畏虎
你信写完老吗	你信写完了吗
他潜心研究音乐	他潜心研究音乐
他莫得任何朋友玩	他没有任何朋友玩
他全神贯注	他全神贯注
你家有几口人	你家有几口人
我和他竞争冠军	我和他竞争冠军
我还没读完这本书	我还没读完这本书
我在大学主修化学	我在大学主修化学
我在大学主修哲学	我在大学主修哲学
我需要跟你说点事	我需要跟你说点事
我觉得你想坐下	我觉得你想坐下
我当时是高中生	我当时是高中生
我在学校前面等你	我在学校前面等你
我肯定这是淡水鱼	我肯定这是淡水鱼
莫得必要回那封信	没有必要回那封信
学习外语是困难的	学习外语是困难的
请尽快回家	请尽快回家
请把披萨分成三份	请把披萨分成三份
她榨老许多柳橙汁	她榨了许多柳橙汁
空调坏老	空调坏了
男孩在玩玩具兵	男孩在玩玩具兵
孩子们早上切学校	孩子们早上去学校
后天是汤姆的生日	后天是汤姆的生日
图书馆位于市中央	图书馆位于市中央
老师说地球是圆的	老师说地球是圆的
这些照片真美	这些照片真美
他们直奔目的地	他们直奔目的地
这药莫得副作用	这药没有副作用
汤姆没时间吃午饭	汤姆没时间吃午饭
汤姆尽全力省钱	汤姆尽全力省钱
水沸腾后变为蒸汽	水沸腾后变为蒸汽
我们期望今年丰收	我们期望今年丰收
你应该帮他工作的	你应该帮他工作的
你得注意他说的话	你得注意他说的话
你进入老危险区	你进入了危险区
前天发生老火灾	前天发生了火灾
农民总是抱怨天气	农民总是抱怨天气
他与他的邻居相处	他与他的邻居相处
他和他的邻居相处	他和他的邻居相处
你会写多少汉字	你会写多少汉字
我感谢你帮助澄清	我感谢你帮助澄清
我需要尽快完成	我需要尽快完成
我全天在家读小说	我全天在家读小说
如果你想说就说	如果你想说就说
夏天我穿短袖衬衫	夏天我穿短袖衬衫
他肯定要切美国	他肯定要去美国
在美国的人说英语	在美国的人说英语
狗在地毯上睡过	狗在地毯上睡过
警方能够找到罪犯	警方能够找到罪犯
河在山丘的另一端	河在山丘的另一端
大雨使河水泛滥	大雨使河水泛滥
富士山顶盖满老雪	富士山顶盖满了雪
列车晚到老十分钟	列车晚到了十分钟
英国的天气经常变	英国的天气经常变
人口稳定地增加	人口稳定地增加
他们忙于社会改革	他们忙于社会改革
哪个都希望世界和平	谁都希望世界和平
我们要做的很简单	我们要做的很简单
你打算切哪儿过夜	你打算去哪儿过夜
你喜不喜欢没关系	你喜不喜欢没关系
你的方向感很好	你的方向感很好
你应该努力切戒烟	你应该努力去戒烟
电流可以产生磁性	电流可以产生磁性
你相信死后永生吗	你相信死后永生吗
他的影响遍及全国	他的影响遍及全国
我建议你转身回家	我建议你转身回家
我等老接近半小时	我等了接近半小时
我下个月将切澳洲	我下个月将去澳洲
日本依赖进口原料	日本依赖进口原料
这钱你和我分老吧	这钱你和我分了吧
在服务台另外预约	在服务台另外预约
许多移民改老名字	许多移民改了名字
过马路时请小心	过马路时请小心
她提出老入学申请	她提出了入学申请
她总和她父母吵架	她总和她父母吵架
她比其他人都漂亮	她比其他人都漂亮
这是条有趣的信息	这是条有趣的信息
山顶被雪复盖老	山顶被雪复盖了
理论得联系实际	理论得联系实际
乡间有很多树	乡间有很多树
没人不渴望和平	没人不渴望和平
装病是没用的	装病是没用的
这家店在卖蔬菜	这家店在卖蔬菜
汤姆刚从邮局回来	汤姆刚从邮局回来
汤姆人在心不在	汤姆人在心不在
我不想参加典礼	我不想参加典礼
我明早八点来接你	我明早八点来接你
下老三小时大雨	下了三小时大雨
日本位于北半球	日本位于北半球
生产日期在盖子上	生产日期在盖子上
美国有50个州	美国有50个州
吃早餐之前先浇花	吃早餐之前先浇花
我们周三下午没课	我们周三下午没课
你一共花老多少钱	你一共花了多少钱
你能用圆珠笔写吗	你能用圆珠笔写吗
你其实没必要带伞	你其实没必要带伞
你的提议值得考虑	你的提议值得考虑
他身肩重任	他身肩重任
你参加社团活动吗	你参加社团活动吗
我等你把作业做完	我等你把作业做完
不要听风就是雨	不要听风就是雨
今天莫得昨天潮溼	今天没有昨天潮溼
今天不比昨天闷热	今天不比昨天闷热
区分善恶不容易	区分善恶不容易
她下午会洗自行车	她下午会洗自行车
拍照片光线不够亮	拍照片光线不够亮
汤姆学老几年法语	汤姆学了几年法语
不幸的是电话坏老	不幸的是电话坏了
到外国一定很贵	到外国一定很贵
我们促膝谈心	我们促膝谈心
请你看看这些文件	请你看看这些文件
你应该光荣地辞职	你应该光荣地辞职
你最好未雨绸缪	你最好未雨绸缪
我不想有任何误会	我不想有任何误会
老人试图游5公里	老人试图游5公里
红旗代表存在危险	红旗代表存在危险
汤姆在会议室等你	汤姆在会议室等你
UK是英国的缩写	UK是英国的缩写
汤姆所言不符时局	汤姆所言不符时局
我真想再见见汤姆	我真想再见见汤姆
事故发生在前天	事故发生在前天
能否请你说慢一点	能否请你说慢一点
你必需马上切那儿	你必需马上去那儿
这双胞胎没法区分	这双胞胎没法区分
草莓在冬天售价高	草莓在冬天售价高
么女长得特别漂亮	么女长得特别漂亮
明天很有可能下雨	明天很有可能下雨
她背痛老好多年老	她背痛了好多年了
明早八点车站见	明早八点车站见
他好坏不分	他好坏不分
奥运会已经开幕老	奥运会已经开幕了
明天天气晴转阵雨	明天天气晴转阵雨
我爱你	我爱你
我爱你3000遍	我爱你3000遍
我爱你一万年	我爱你一万年
爱你一万年	爱你一万年
你爱不爱我	你爱不爱我
你爱我吗	你爱我吗
爱是做出来的	爱是做出来的
因为爱所以爱	因为爱所以爱
我要吃嘎嘎	我要吃肉肉
我要吃肉	我要吃肉
我要吃肉肉	我要吃肉肉
我想吃嘎嘎	我想吃肉肉
我想吃肉	我想吃肉
这个肉好香啊	这个肉好香啊
这个肉好吃	这个肉好吃
我要吃饭	我要吃饭
我要吃茫茫	我要吃饭饭
我要吃茫茫	我要吃饭
老子明天不上班	我明天不上班
吃鸡老	吃鸡了
老子带你吃鸡	爸爸带你吃鸡
老子带你飞	爸爸带你飞
姐带你飞	姐带你飞
姐姐带你飞	姐姐带你飞
哥带你飞	哥带你飞
姐带你吃鸡	姐带你吃鸡
哥带你吃鸡	哥带你吃鸡
天不怕地不怕	天不怕地不怕
天不怕地不怕	天不怕地不怕
就怕普通人讲四川话	就怕普通人说四川话
讲四川话	说四川话
我讲四川话你听得懂不	我说四川话你能听懂不
复仇者联盟	复仇者联盟
钢铁侠	钢铁侠
你是猪嘛	你是猪吗
你啷个这们瓜啊	你怎么这么蠢啊
你个瓜娃子	你个傻孩子
这个人好瓜啊	这个人好蠢啊
这个人好瓜啊	这个人好笨啊
吃瓜群众	吃瓜群众
当个吃瓜群众不好吗	当个吃瓜群众不好吗
跟我装	跟我装
你以为你是熊猫	你以为你是熊猫
我就不敢捶你嘛	我就不敢揍你吗
不要打捶	不要打架
人工自藏	人工智障
